ID,Type,Submit Time,Start Time,End Time,Wait Time,Makespan,Turnaround Time,Status
0,rigid,0,0,1423,0,1423,1423,completed
1,rigid,0,0,22868,0,22868,22868,completed
2,rigid,207,207,19883,0,19676,19676,completed
3,rigid,276,276,23140,0,22864,22864,completed
4,rigid,542,542,23464,0,22922,22922,completed
5,rigid,715,715,1163,0,448,448,completed
6,rigid,715,715,1187,0,472,472,completed
7,rigid,715,715,1135,0,420,420,completed
8,rigid,721,721,3421,0,2700,2700,completed
9,rigid,770,770,1426,0,656,656,completed
10,rigid,1053,1053,5635,0,4582,4582,completed
11,rigid,1053,1053,5292,0,4239,4239,completed
12,rigid,1053,1053,6133,0,5080,5080,completed
13,rigid,1053,1053,5377,0,4324,4324,completed
14,rigid,1053,1053,5026,0,3973,3973,completed
15,rigid,1053,1053,5428,0,4375,4375,completed
16,rigid,1053,1053,5482,0,4429,4429,completed
17,rigid,1054,1054,4881,0,3827,3827,completed
18,rigid,1054,1054,5220,0,4166,4166,completed
19,rigid,1054,1054,5601,0,4547,4547,completed
20,rigid,1054,1054,6049,0,4995,4995,completed
21,rigid,1054,1054,4818,0,3764,3764,completed
22,rigid,1054,1054,5014,0,3960,3960,completed
23,rigid,1054,1054,4891,0,3837,3837,completed
24,rigid,1054,1054,5061,0,4007,4007,completed
25,rigid,1054,1054,6306,0,5252,5252,completed
26,rigid,1115,1115,1757,0,642,642,completed
27,rigid,1222,1222,6003,0,4781,4781,completed
28,rigid,1223,1223,5618,0,4395,4395,completed
29,rigid,1223,1223,5745,0,4522,4522,completed
30,rigid,1223,1223,5844,0,4621,4621,completed
31,rigid,1223,1223,6020,0,4797,4797,completed
32,rigid,1225,1225,6236,0,5011,5011,completed
33,rigid,1228,1228,5240,0,4012,4012,completed
34,rigid,1230,1230,5707,0,4477,4477,completed
35,rigid,1231,1231,5586,0,4355,4355,completed
36,rigid,1233,1233,5492,0,4259,4259,completed
37,rigid,1234,1234,5871,0,4637,4637,completed
38,rigid,1234,1234,5703,0,4469,4469,completed
39,rigid,1234,1234,4952,0,3718,3718,completed
40,rigid,1234,1234,6107,0,4873,4873,completed
41,rigid,1234,1234,6201,0,4967,4967,completed
42,rigid,1235,1235,5285,0,4050,4050,completed
43,rigid,1516,1516,4644,0,3128,3128,completed
44,rigid,1609,1609,4529,0,2920,2920,completed
45,rigid,1624,1624,2407,0,783,783,completed
46,rigid,1630,1630,5529,0,3899,3899,completed
47,rigid,1630,1630,6592,0,4962,4962,completed
48,rigid,1630,1630,7397,0,5767,5767,completed
49,rigid,1630,1630,6092,0,4462,4462,completed
50,rigid,1630,1630,6103,0,4473,4473,completed
51,rigid,1630,1630,5623,0,3993,3993,completed
52,rigid,1630,1630,5488,0,3858,3858,completed
53,rigid,1630,1630,5956,0,4326,4326,completed
54,rigid,1630,1630,5244,0,3614,3614,completed
55,rigid,1630,1630,6478,0,4848,4848,completed
56,rigid,1630,1630,5870,0,4240,4240,completed
57,rigid,1630,1630,6240,0,4610,4610,completed
58,rigid,1630,1630,5492,0,3862,3862,completed
59,rigid,1630,1630,6769,0,5139,5139,completed
60,rigid,1630,1630,5261,0,3631,3631,completed
61,rigid,1630,1630,7044,0,5414,5414,completed
62,rigid,1641,1641,4397,0,2756,2756,completed
63,rigid,1681,1681,2413,0,732,732,completed
64,rigid,1681,1681,2152,0,471,471,completed
65,rigid,1698,1698,3176,0,1478,1478,completed
66,rigid,1723,1723,4522,0,2799,2799,completed
67,rigid,1942,1942,7501,0,5559,5559,completed
68,rigid,1942,1942,8240,0,6298,6298,completed
69,rigid,1942,1942,7115,0,5173,5173,completed
70,rigid,1942,1942,5959,0,4017,4017,completed
71,rigid,1942,1942,5159,0,3217,3217,completed
72,rigid,1942,1942,7745,0,5803,5803,completed
73,rigid,1942,1942,8280,0,6338,6338,completed
74,rigid,1942,1942,5995,0,4053,4053,completed
75,rigid,1942,1942,6577,0,4635,4635,completed
76,rigid,1942,1942,6689,0,4747,4747,completed
77,rigid,1942,1942,7017,0,5075,5075,completed
78,rigid,1942,1942,5848,0,3906,3906,completed
79,rigid,1942,1942,7076,0,5134,5134,completed
80,rigid,1942,1942,5987,0,4045,4045,completed
81,rigid,1942,1942,5276,0,3334,3334,completed
82,rigid,1942,1942,6696,0,4754,4754,completed
83,rigid,2029,2029,2359,0,330,330,completed
84,rigid,2029,2029,2744,0,715,715,completed
85,rigid,2423,2423,5015,0,2592,2592,completed
86,rigid,2459,2459,24902,0,22443,22443,completed
87,rigid,2616,2616,4109,0,1493,1493,completed
88,rigid,3359,3359,3964,0,605,605,completed
89,rigid,3359,3359,3972,0,613,613,completed
90,rigid,3359,3359,3919,0,560,560,completed
91,rigid,3359,3359,3853,0,494,494,completed
92,rigid,3359,3359,3947,0,588,588,completed
93,rigid,3359,3359,4022,0,663,663,completed
94,rigid,3359,3359,4039,0,680,680,completed
95,rigid,3359,3359,3965,0,606,606,completed
96,rigid,3359,3359,3967,0,608,608,completed
97,rigid,3359,3359,4015,0,656,656,completed
98,rigid,3359,3359,3993,0,634,634,completed
99,rigid,3359,3359,3902,0,543,543,completed
100,rigid,3359,3359,4871,0,1512,1512,completed
101,rigid,3360,3360,4834,0,1474,1474,completed
102,rigid,3382,3382,6838,0,3456,3456,completed
103,rigid,3385,3385,4028,0,643,643,completed
104,rigid,3385,3385,3999,0,614,614,completed
105,rigid,3385,3385,3933,0,548,548,completed
106,rigid,3385,3385,3989,0,604,604,completed
107,rigid,3385,3385,3976,0,591,591,completed
108,rigid,3385,3385,3974,0,589,589,completed
109,rigid,3385,3385,4042,0,657,657,completed
110,rigid,3385,3421,4022,36,601,637,completed
111,rigid,3385,3421,3991,36,570,606,completed
112,rigid,3385,3421,4043,36,622,658,completed
113,rigid,3385,3421,4031,36,610,646,completed
114,rigid,3385,3853,4447,468,594,1062,completed
115,rigid,3393,3902,4626,509,724,1233,completed
116,rigid,3393,3919,4640,526,721,1247,completed
117,rigid,3393,3933,4616,540,683,1223,completed
118,rigid,3393,3947,4655,554,708,1262,completed
119,rigid,3393,3964,4695,571,731,1302,completed
120,rigid,3393,3965,4665,572,700,1272,completed
121,rigid,3393,3967,4651,574,684,1258,completed
122,rigid,3393,3972,4485,579,513,1092,completed
123,rigid,3393,3974,4569,581,595,1176,completed
124,rigid,3393,3976,4670,583,694,1277,completed
125,rigid,3393,3989,4741,596,752,1348,completed
126,rigid,3393,3991,4747,598,756,1354,completed
127,rigid,3395,3993,4592,598,599,1197,completed
128,rigid,3395,3999,4838,604,839,1443,completed
129,rigid,3395,4015,4871,620,856,1476,completed
130,rigid,3395,4022,4893,627,871,1498,completed
131,rigid,3395,4022,4742,627,720,1347,completed
132,rigid,3395,4028,4776,633,748,1381,completed
133,rigid,3395,4031,4837,636,806,1442,completed
134,rigid,3395,4039,4803,644,764,1408,completed
135,rigid,3395,4042,4705,647,663,1310,completed
136,rigid,3395,4043,4770,648,727,1375,completed
137,rigid,3395,4109,4847,714,738,1452,completed
138,rigid,3395,4109,4902,714,793,1507,completed
139,rigid,3419,4109,4907,690,798,1488,completed
140,rigid,3724,4397,7937,673,3540,4213,completed
141,rigid,3885,4397,4716,512,319,831,completed
142,rigid,3886,4447,4784,561,337,898,completed
143,rigid,3941,4529,7725,588,3196,3784,completed
144,rigid,3945,4644,7590,699,2946,3645,completed
145,rigid,3946,4670,7641,724,2971,3695,completed
146,rigid,3947,4776,7657,829,2881,3710,completed
147,rigid,3951,4834,7704,883,2870,3753,completed
148,rigid,4177,4834,5535,657,701,1358,completed
149,rigid,4219,4834,4908,615,74,689,completed
150,rigid,4221,4834,5375,613,541,1154,completed
151,rigid,4224,4834,4840,610,6,616,completed
152,rigid,4227,4834,4835,607,1,608,completed
153,rigid,4227,4834,4835,607,1,608,completed
154,rigid,4228,4834,4836,606,2,608,completed
155,rigid,4229,4834,4854,605,20,625,completed
156,rigid,4272,4834,6354,562,1520,2082,completed
157,rigid,4273,4834,5816,561,982,1543,completed
158,rigid,4273,4835,5759,562,924,1486,completed
159,rigid,4273,4840,5965,567,1125,1692,completed
160,rigid,4273,4871,5737,598,866,1464,completed
161,rigid,4275,4871,5733,596,862,1458,completed
162,rigid,4277,4871,5737,594,866,1460,completed
163,rigid,4278,4871,4873,593,2,595,completed
164,rigid,4278,4871,5965,593,1094,1687,completed
165,rigid,4278,4871,5687,593,816,1409,completed
166,rigid,4278,4873,5984,595,1111,1706,completed
167,rigid,4278,4881,5456,603,575,1178,completed
168,rigid,4278,4891,5760,613,869,1482,completed
169,rigid,4278,4907,5778,629,871,1500,completed
170,rigid,4278,4952,6399,674,1447,2121,completed
171,rigid,4278,5014,5721,736,707,1443,completed
172,rigid,4278,5026,5589,748,563,1311,completed
173,rigid,4291,5026,5458,735,432,1167,completed
174,rigid,4292,5061,5925,769,864,1633,completed
175,rigid,4292,5159,6023,867,864,1731,completed
176,rigid,4292,5220,6084,928,864,1792,completed
177,rigid,4292,5240,6086,948,846,1794,completed
178,rigid,4292,5244,6108,952,864,1816,completed
179,rigid,4292,5261,6115,969,854,1823,completed
180,rigid,4292,5276,6140,984,864,1848,completed
181,rigid,4292,5285,6149,993,864,1857,completed
182,rigid,4292,5292,6156,1000,864,1864,completed
183,rigid,4292,5377,6214,1085,837,1922,completed
184,rigid,4292,5428,6284,1136,856,1992,completed
185,rigid,4292,5456,6306,1164,850,2014,completed
186,rigid,4292,5482,6346,1190,864,2054,completed
187,rigid,4292,5488,6352,1196,864,2060,completed
188,rigid,4292,5492,6356,1200,864,2064,completed
189,rigid,4303,5492,5587,1189,95,1284,completed
190,rigid,4303,5529,5626,1226,97,1323,completed
191,rigid,4303,5535,5633,1232,98,1330,completed
192,rigid,4303,5586,5675,1283,89,1372,completed
193,rigid,4303,5587,5689,1284,102,1386,completed
194,rigid,4303,5589,5787,1286,198,1484,completed
195,rigid,4303,5601,5703,1298,102,1400,completed
196,rigid,4303,5618,5778,1315,160,1475,completed
197,rigid,4303,5623,5702,1320,79,1399,completed
198,rigid,4303,5626,5709,1323,83,1406,completed
199,rigid,4303,5633,5731,1330,98,1428,completed
200,rigid,4307,5635,5673,1328,38,1366,completed
201,rigid,4307,5673,5873,1366,200,1566,completed
202,rigid,4307,5675,5831,1368,156,1524,completed
203,rigid,4307,5687,5882,1380,195,1575,completed
204,rigid,4307,5689,5884,1382,195,1577,completed
205,rigid,4307,5702,5897,1395,195,1590,completed
206,rigid,4332,5702,5706,1370,4,1374,completed
207,rigid,4341,5703,5706,1362,3,1365,completed
208,rigid,4348,5703,5706,1355,3,1358,completed
209,rigid,4392,5703,7161,1311,1458,2769,completed
210,rigid,4429,5706,16671,1277,10965,12242,completed
211,rigid,4458,5706,5709,1248,3,1251,completed
212,rigid,4462,5707,5734,1245,27,1272,completed
213,rigid,4463,5709,5711,1246,2,1248,completed
214,rigid,4469,5709,5712,1240,3,1243,completed
215,rigid,4523,5709,5710,1186,1,1187,completed
216,rigid,4525,5709,5710,1184,1,1185,completed
217,rigid,4538,5709,5830,1171,121,1292,completed
218,rigid,4550,5712,6096,1162,384,1546,completed
219,rigid,4550,5721,6057,1171,336,1507,completed
220,rigid,4550,5731,6092,1181,361,1542,completed
221,rigid,4550,5733,6092,1183,359,1542,completed
222,rigid,4550,5734,6034,1184,300,1484,completed
223,rigid,4550,5737,6104,1187,367,1554,completed
224,rigid,4550,5737,6119,1187,382,1569,completed
225,rigid,4550,5745,6189,1195,444,1639,completed
226,rigid,4550,5759,6010,1209,251,1460,completed
227,rigid,4550,5760,6145,1210,385,1595,completed
228,rigid,4550,5778,6081,1228,303,1531,completed
229,rigid,4550,5778,6120,1228,342,1570,completed
230,rigid,4550,5787,6100,1237,313,1550,completed
231,rigid,4550,5816,6086,1266,270,1536,completed
232,rigid,4550,5831,6147,1281,316,1597,completed
233,rigid,4550,5844,6151,1294,307,1601,completed
234,rigid,4550,5848,6253,1298,405,1703,completed
235,rigid,4550,5870,6193,1320,323,1643,completed
236,rigid,4550,5871,6192,1321,321,1642,completed
237,rigid,4550,5873,6180,1323,307,1630,completed
238,rigid,4550,5882,6289,1332,407,1739,completed
239,rigid,4550,5884,6173,1334,289,1623,completed
240,rigid,4550,5897,6301,1347,404,1751,completed
241,rigid,4550,5925,6251,1375,326,1701,completed
242,rigid,4550,5956,6267,1406,311,1717,completed
243,rigid,4550,5959,6340,1409,381,1790,completed
244,rigid,4550,5965,6234,1415,269,1684,completed
245,rigid,4550,5965,6347,1415,382,1797,completed
246,rigid,4550,5984,6329,1434,345,1779,completed
247,rigid,4550,5987,6309,1437,322,1759,completed
248,rigid,4550,5995,6372,1445,377,1822,completed
249,rigid,4550,6003,6319,1453,316,1769,completed
250,rigid,4550,6010,6413,1460,403,1863,completed
251,rigid,4550,6020,6417,1470,397,1867,completed
252,rigid,4550,6023,6369,1473,346,1819,completed
253,rigid,4550,6034,6434,1484,400,1884,completed
254,rigid,4550,6049,6405,1499,356,1855,completed
255,rigid,4550,6057,6377,1507,320,1827,completed
256,rigid,4550,6081,6390,1531,309,1840,completed
257,rigid,4550,6084,6362,1534,278,1812,completed
258,rigid,4550,6086,6413,1536,327,1863,completed
259,rigid,4550,6086,6393,1536,307,1843,completed
260,rigid,4550,6092,6358,1542,266,1808,completed
261,rigid,4550,6092,6532,1542,440,1982,completed
262,rigid,4550,6092,6442,1542,350,1892,completed
263,rigid,4550,6096,6401,1546,305,1851,completed
264,rigid,4550,6100,6460,1550,360,1910,completed
265,rigid,4550,6103,6393,1553,290,1843,completed
266,rigid,4550,6104,6469,1554,365,1919,completed
267,rigid,4550,6107,6447,1557,340,1897,completed
268,rigid,4550,6108,6363,1558,255,1813,completed
269,rigid,4550,6115,6436,1565,321,1886,completed
270,rigid,4550,6119,6432,1569,313,1882,completed
271,rigid,4550,6120,6438,1570,318,1888,completed
272,rigid,4550,6133,6477,1583,344,1927,completed
273,rigid,4550,6140,6556,1590,416,2006,completed
274,rigid,4550,6145,6542,1595,397,1992,completed
275,rigid,4550,6147,6373,1597,226,1823,completed
276,rigid,4550,6149,6460,1599,311,1910,completed
277,rigid,4550,6151,6458,1601,307,1908,completed
278,rigid,4550,6156,6485,1606,329,1935,completed
279,rigid,4550,6173,6554,1623,381,2004,completed
280,rigid,4550,6180,6473,1630,293,1923,completed
281,rigid,4550,6189,6587,1639,398,2037,completed
282,rigid,4550,6192,6523,1642,331,1973,completed
283,rigid,4550,6193,6535,1643,342,1985,completed
284,rigid,4550,6201,6498,1651,297,1948,completed
285,rigid,4550,6214,6595,1664,381,2045,completed
286,rigid,4550,6234,6527,1684,293,1977,completed
287,rigid,4550,6236,6599,1686,363,2049,completed
288,rigid,4550,6240,6516,1690,276,1966,completed
289,rigid,4550,6251,6597,1701,346,2047,completed
290,rigid,4550,6253,6609,1703,356,2059,completed
291,rigid,4550,6267,6613,1717,346,2063,completed
292,rigid,4550,6284,6700,1734,416,2150,completed
293,rigid,4550,6289,6687,1739,398,2137,completed
294,rigid,4550,6301,6632,1751,331,2082,completed
295,rigid,4550,6306,6665,1756,359,2115,completed
296,rigid,4550,6306,6605,1756,299,2055,completed
297,rigid,4550,6309,6678,1759,369,2128,completed
298,rigid,4550,6319,6694,1769,375,2144,completed
299,rigid,4550,6329,6649,1779,320,2099,completed
300,rigid,4550,6340,6772,1790,432,2222,completed
301,rigid,4550,6346,6714,1796,368,2164,completed
302,rigid,4550,6347,6694,1797,347,2144,completed
303,rigid,4550,6352,6777,1802,425,2227,completed
304,rigid,4550,6354,6723,1804,369,2173,completed
305,rigid,4550,6356,6668,1806,312,2118,completed
306,rigid,4550,6358,6731,1808,373,2181,completed
307,rigid,4550,6362,6733,1812,371,2183,completed
308,rigid,4550,6363,6715,1813,352,2165,completed
309,rigid,4550,6369,6752,1819,383,2202,completed
310,rigid,4550,6372,6745,1822,373,2195,completed
311,rigid,4550,6373,6659,1823,286,2109,completed
312,rigid,4550,6377,6715,1827,338,2165,completed
313,rigid,4550,6390,6849,1840,459,2299,completed
314,rigid,4550,6393,6667,1843,274,2117,completed
315,rigid,4550,6393,6757,1843,364,2207,completed
316,rigid,4550,6399,6733,1849,334,2183,completed
317,rigid,4550,6401,6707,1851,306,2157,completed
318,rigid,4550,6405,6768,1855,363,2218,completed
319,rigid,4550,6413,6708,1863,295,2158,completed
320,rigid,4550,6413,6748,1863,335,2198,completed
321,rigid,4550,6417,6720,1867,303,2170,completed
322,rigid,4550,6432,6721,1882,289,2171,completed
323,rigid,4550,6434,6722,1884,288,2172,completed
324,rigid,4550,6436,6734,1886,298,2184,completed
325,rigid,4550,6438,6796,1888,358,2246,completed
326,rigid,4550,6442,6774,1892,332,2224,completed
327,rigid,4550,6447,6697,1897,250,2147,completed
328,rigid,4550,6458,6790,1908,332,2240,completed
329,rigid,4550,6460,6736,1910,276,2186,completed
330,rigid,4550,6460,6755,1910,295,2205,completed
331,rigid,4550,6469,6770,1919,301,2220,completed
332,rigid,4550,6473,6787,1923,314,2237,completed
333,rigid,4550,6477,6832,1927,355,2282,completed
334,rigid,4550,6478,6799,1928,321,2249,completed
335,rigid,4550,6485,6819,1935,334,2269,completed
336,rigid,4550,6498,6818,1948,320,2268,completed
337,rigid,4550,6516,6868,1966,352,2318,completed
338,rigid,4550,6523,6881,1973,358,2331,completed
339,rigid,4550,6527,6830,1977,303,2280,completed
340,rigid,4550,6532,6853,1982,321,2303,completed
341,rigid,4550,6535,6841,1985,306,2291,completed
342,rigid,4550,6542,6901,1992,359,2351,completed
343,rigid,4550,6554,6940,2004,386,2390,completed
344,rigid,4550,6556,6874,2006,318,2324,completed
345,rigid,4550,6577,6903,2027,326,2353,completed
346,rigid,4550,6587,6920,2037,333,2370,completed
347,rigid,4550,6592,6977,2042,385,2427,completed
348,rigid,4550,6595,6956,2045,361,2406,completed
349,rigid,4550,6597,6906,2047,309,2356,completed
350,rigid,4550,6599,7028,2049,429,2478,completed
351,rigid,4550,6605,7008,2055,403,2458,completed
352,rigid,4550,6609,6923,2059,314,2373,completed
353,rigid,4550,6613,6928,2063,315,2378,completed
354,rigid,4550,6632,6951,2082,319,2401,completed
355,rigid,4550,6649,7011,2099,362,2461,completed
356,rigid,4550,6659,7065,2109,406,2515,completed
357,rigid,4550,6665,7062,2115,397,2512,completed
358,rigid,4550,6667,6955,2117,288,2405,completed
359,rigid,4550,6668,7052,2118,384,2502,completed
360,rigid,4550,6678,7054,2128,376,2504,completed
361,rigid,4550,6687,7085,2137,398,2535,completed
362,rigid,4550,6689,7101,2139,412,2551,completed
363,rigid,4550,6694,6904,2144,210,2354,completed
364,rigid,4550,6694,7048,2144,354,2498,completed
365,rigid,4550,6696,7014,2146,318,2464,completed
366,rigid,4550,6697,6990,2147,293,2440,completed
367,rigid,4550,6700,7054,2150,354,2504,completed
368,rigid,4550,6707,7049,2157,342,2499,completed
369,rigid,4550,6708,7080,2158,372,2530,completed
370,rigid,4550,6714,7052,2164,338,2502,completed
371,rigid,4550,6715,7114,2165,399,2564,completed
372,rigid,4550,6715,7035,2165,320,2485,completed
373,rigid,4550,6720,6979,2170,259,2429,completed
374,rigid,4550,6721,7043,2171,322,2493,completed
375,rigid,4550,6722,7068,2172,346,2518,completed
376,rigid,4550,6723,7045,2173,322,2495,completed
377,rigid,4550,6731,7075,2181,344,2525,completed
378,rigid,4550,6733,7066,2183,333,2516,completed
379,rigid,4550,6733,7124,2183,391,2574,completed
380,rigid,4550,6734,7119,2184,385,2569,completed
381,rigid,4550,6736,7200,2186,464,2650,completed
382,rigid,4551,6745,7242,2194,497,2691,completed
383,rigid,4551,6748,7213,2197,465,2662,completed
384,rigid,4551,6752,7154,2201,402,2603,completed
385,rigid,4551,6755,7202,2204,447,2651,completed
386,rigid,4551,6757,6867,2206,110,2316,completed
387,rigid,4551,6768,7081,2217,313,2530,completed
388,rigid,4551,6769,7384,2218,615,2833,completed
389,rigid,4551,6770,7222,2219,452,2671,completed
390,rigid,4551,6772,7275,2221,503,2724,completed
391,rigid,4551,6774,7144,2223,370,2593,completed
392,rigid,4551,6777,7316,2226,539,2765,completed
393,rigid,4551,6787,7247,2236,460,2696,completed
394,rigid,4551,6790,7249,2239,459,2698,completed
395,rigid,4551,6796,7358,2245,562,2807,completed
396,rigid,4551,6799,7218,2248,419,2667,completed
397,rigid,4551,6818,7261,2267,443,2710,completed
398,rigid,4551,6819,7195,2268,376,2644,completed
399,rigid,4551,6830,7288,2279,458,2737,completed
400,rigid,4551,6832,7318,2281,486,2767,completed
401,rigid,4551,6838,7304,2287,466,2753,completed
402,rigid,4551,6838,7317,2287,479,2766,completed
403,rigid,4551,6841,7396,2290,555,2845,completed
404,rigid,4551,6849,7357,2298,508,2806,completed
405,rigid,4551,6853,7328,2302,475,2777,completed
406,rigid,4551,6867,7373,2316,506,2822,completed
407,rigid,4551,6868,7352,2317,484,2801,completed
408,rigid,4551,6874,7367,2323,493,2816,completed
409,rigid,4551,6881,7287,2330,406,2736,completed
410,rigid,4551,6901,7318,2350,417,2767,completed
411,rigid,4551,6903,7434,2352,531,2883,completed
412,rigid,4551,6904,7376,2353,472,2825,completed
413,rigid,4551,6906,7437,2355,531,2886,completed
414,rigid,4551,6920,7359,2369,439,2808,completed
415,rigid,4551,6923,7570,2372,647,3019,completed
416,rigid,4551,6928,7358,2377,430,2807,completed
417,rigid,4551,6940,7443,2389,503,2892,completed
418,rigid,4551,6951,7333,2400,382,2782,completed
419,rigid,4551,6955,7432,2404,477,2881,completed
420,rigid,4551,6956,7484,2405,528,2933,completed
421,rigid,4551,6977,7432,2426,455,2881,completed
422,rigid,4551,6979,7385,2428,406,2834,completed
423,rigid,4551,6990,7449,2439,459,2898,completed
424,rigid,4551,7008,7484,2457,476,2933,completed
425,rigid,4551,7011,7477,2460,466,2926,completed
426,rigid,4551,7014,7509,2463,495,2958,completed
427,rigid,4551,7017,7579,2466,562,3028,completed
428,rigid,4551,7028,7505,2477,477,2954,completed
429,rigid,4551,7035,7490,2484,455,2939,completed
430,rigid,4551,7043,7465,2492,422,2914,completed
431,rigid,4551,7044,7498,2493,454,2947,completed
432,rigid,4551,7045,7564,2494,519,3013,completed
433,rigid,4578,7048,9816,2470,2768,5238,completed
434,rigid,4596,7048,7418,2452,370,2822,completed
435,rigid,4620,7049,8777,2429,1728,4157,completed
436,rigid,4620,7052,8754,2432,1702,4134,completed
437,rigid,4621,7052,8780,2431,1728,4159,completed
438,rigid,4623,7052,7682,2429,630,3059,completed
439,rigid,4635,7052,8745,2417,1693,4110,completed
440,rigid,4635,7052,8780,2417,1728,4145,completed
441,rigid,4735,7052,7053,2317,1,2318,completed
442,rigid,4736,7053,9665,2317,2612,4929,completed
443,rigid,4737,7054,7378,2317,324,2641,completed
444,rigid,4739,7054,9169,2315,2115,4430,completed
445,rigid,4768,7054,7083,2286,29,2315,completed
446,rigid,4882,7062,9742,2180,2680,4860,completed
447,rigid,4900,7065,7370,2165,305,2470,completed
448,rigid,4907,7066,7096,2159,30,2189,completed
449,rigid,4941,7066,7094,2125,28,2153,completed
450,rigid,4965,7068,7300,2103,232,2335,completed
451,rigid,4971,7068,7955,2097,887,2984,completed
452,rigid,4971,7075,7715,2104,640,2744,completed
453,rigid,4971,7075,7720,2104,645,2749,completed
454,rigid,4972,7075,7426,2103,351,2454,completed
455,rigid,4972,7075,7554,2103,479,2582,completed
456,rigid,4972,7076,8059,2104,983,3087,completed
457,rigid,4973,7076,7785,2103,709,2812,completed
458,rigid,4973,7076,7933,2103,857,2960,completed
459,rigid,4973,7076,7952,2103,876,2979,completed
460,rigid,4974,7080,7755,2106,675,2781,completed
461,rigid,4974,7080,8012,2106,932,3038,completed
462,rigid,4974,7080,7618,2106,538,2644,completed
463,rigid,4999,7080,8808,2081,1728,3809,completed
464,rigid,4999,7081,8809,2082,1728,3810,completed
465,rigid,4999,7081,8809,2082,1728,3810,completed
466,rigid,5002,7081,8809,2079,1728,3807,completed
467,rigid,5002,7081,8809,2079,1728,3807,completed
468,rigid,5002,7083,8811,2081,1728,3809,completed
469,rigid,5003,7083,8811,2080,1728,3808,completed
470,rigid,5003,7085,8813,2082,1728,3810,completed
471,rigid,5003,7085,8813,2082,1728,3810,completed
472,rigid,5004,7085,8813,2081,1728,3809,completed
473,rigid,5004,7085,8813,2081,1728,3809,completed
474,rigid,5004,7094,8822,2090,1728,3818,completed
475,rigid,5004,7094,8822,2090,1728,3818,completed
476,rigid,5004,7096,8824,2092,1728,3820,completed
477,rigid,5004,7096,8824,2092,1728,3820,completed
478,rigid,5005,7101,8829,2096,1728,3824,completed
479,rigid,5005,7101,8829,2096,1728,3824,completed
480,rigid,5005,7101,8829,2096,1728,3824,completed
481,rigid,5006,7101,8539,2095,1438,3533,completed
482,rigid,5006,7114,8842,2108,1728,3836,completed
483,rigid,5006,7114,8842,2108,1728,3836,completed
484,rigid,5007,7114,8842,2107,1728,3835,completed
485,rigid,5007,7114,8842,2107,1728,3835,completed
486,rigid,5007,7115,8843,2108,1728,3836,completed
487,rigid,5008,7115,8843,2107,1728,3835,completed
488,rigid,5008,7115,8843,2107,1728,3835,completed
489,rigid,5008,7115,8843,2107,1728,3835,completed
490,rigid,5008,7119,8847,2111,1728,3839,completed
491,rigid,5008,7119,8847,2111,1728,3839,completed
492,rigid,5008,7119,8847,2111,1728,3839,completed
493,rigid,5009,7119,8847,2110,1728,3838,completed
494,rigid,5009,7124,8852,2115,1728,3843,completed
495,rigid,5009,7124,8852,2115,1728,3843,completed
496,rigid,5009,7124,8852,2115,1728,3843,completed
497,rigid,5009,7124,8852,2115,1728,3843,completed
498,rigid,5009,7144,8872,2135,1728,3863,completed
499,rigid,5010,7144,8872,2134,1728,3862,completed
500,rigid,5010,7144,8872,2134,1728,3862,completed
501,rigid,5010,7144,8872,2134,1728,3862,completed
502,rigid,5029,7195,7307,2166,112,2278,completed
503,rigid,5030,7202,7312,2172,110,2282,completed
504,rigid,5034,7218,7233,2184,15,2199,completed
505,rigid,5037,7218,7247,2181,29,2210,completed
506,rigid,5038,7218,7254,2180,36,2216,completed
507,rigid,5044,7242,7345,2198,103,2301,completed
508,rigid,5045,7247,7920,2202,673,2875,completed
509,rigid,5047,7261,7935,2214,674,2888,completed
510,rigid,5048,7287,7940,2239,653,2892,completed
511,rigid,5048,7304,7882,2256,578,2834,completed
512,rigid,5049,7307,7946,2258,639,2897,completed
513,rigid,5050,7312,7666,2262,354,2616,completed
514,rigid,5051,7316,7522,2265,206,2471,completed
515,rigid,5074,7316,7347,2242,31,2273,completed
516,rigid,5108,7317,7749,2209,432,2641,completed
517,rigid,5142,7318,19414,2176,12096,14272,completed
518,rigid,5146,7333,7899,2187,566,2753,completed
519,rigid,5146,7345,7834,2199,489,2688,completed
520,rigid,5214,7345,7347,2131,2,2133,completed
521,rigid,5220,7345,7346,2125,1,2126,completed
522,rigid,5221,7345,7353,2124,8,2132,completed
523,rigid,5232,7347,7350,2115,3,2118,completed
524,rigid,5232,7347,7566,2115,219,2334,completed
525,rigid,5234,7347,7744,2113,397,2510,completed
526,rigid,5242,7350,7352,2108,2,2110,completed
527,rigid,5244,7352,7952,2108,600,2708,completed
528,rigid,5245,7352,7353,2107,1,2108,completed
529,rigid,5264,7353,9081,2089,1728,3817,completed
530,rigid,5275,7353,7454,2078,101,2179,completed
531,rigid,5275,7357,7387,2082,30,2112,completed
532,rigid,5298,7358,9086,2060,1728,3788,completed
533,rigid,5318,7358,7435,2040,77,2117,completed
534,rigid,5320,7373,8811,2053,1438,3491,completed
535,rigid,5332,7376,12518,2044,5142,7186,completed
536,rigid,5332,7384,12601,2052,5217,7269,completed
537,rigid,5332,7385,12889,2053,5504,7557,completed
538,rigid,5332,7387,11675,2055,4288,6343,completed
539,rigid,5332,7396,11578,2064,4182,6246,completed
540,rigid,5332,7397,14005,2065,6608,8673,completed
541,rigid,5332,7432,13157,2100,5725,7825,completed
542,rigid,5332,7432,12134,2100,4702,6802,completed
543,rigid,5332,7434,13283,2102,5849,7951,completed
544,rigid,5332,7437,13845,2105,6408,8513,completed
545,rigid,5332,7443,11506,2111,4063,6174,completed
546,rigid,5332,7449,11587,2117,4138,6255,completed
547,rigid,5333,7465,13519,2132,6054,8186,completed
548,rigid,5333,7477,10992,2144,3515,5659,completed
549,rigid,5333,7484,11286,2151,3802,5953,completed
550,rigid,5333,7484,11741,2151,4257,6408,completed
551,rigid,5336,7484,7487,2148,3,2151,completed
552,rigid,5350,7484,7487,2134,3,2137,completed
553,rigid,5355,7484,7487,2129,3,2132,completed
554,rigid,5359,7487,7490,2128,3,2131,completed
555,rigid,5387,7490,7491,2103,1,2104,completed
556,rigid,5397,7501,8546,2104,1045,3149,completed
557,rigid,5403,7501,7503,2098,2,2100,completed
558,rigid,5418,7522,7534,2104,12,2116,completed
559,rigid,5508,7522,7597,2014,75,2089,completed
560,rigid,5818,7522,7523,1704,1,1705,completed
561,rigid,5846,7523,7635,1677,112,1789,completed
562,rigid,5849,7534,7565,1685,31,1716,completed
563,rigid,5859,7534,8677,1675,1143,2818,completed
564,rigid,5859,7534,8595,1675,1061,2736,completed
565,rigid,5859,7534,8153,1675,619,2294,completed
566,rigid,5861,7534,8415,1673,881,2554,completed
567,rigid,5861,7534,8673,1673,1139,2812,completed
568,rigid,5861,7534,8782,1673,1248,2921,completed
569,rigid,5863,7534,7538,1671,4,1675,completed
570,rigid,5865,7534,7564,1669,30,1699,completed
571,rigid,5878,7564,7729,1686,165,1851,completed
572,rigid,5878,7564,7984,1686,420,2106,completed
573,rigid,5879,7579,7747,1700,168,1868,completed
574,rigid,5882,7590,7617,1708,27,1735,completed
575,rigid,5883,7635,7798,1752,163,1915,completed
576,rigid,5886,7635,7665,1749,30,1779,completed
577,rigid,5896,7641,7699,1745,58,1803,completed
578,rigid,5898,7657,7791,1759,134,1893,completed
579,rigid,5899,7666,8866,1767,1200,2967,completed
580,rigid,5900,7704,8885,1804,1181,2985,completed
581,rigid,5901,7704,7708,1803,4,1807,completed
582,rigid,5901,7704,7736,1803,32,1835,completed
583,rigid,5902,7704,7736,1802,32,1834,completed
584,rigid,5902,7708,7747,1806,39,1845,completed
585,rigid,5902,7715,7752,1813,37,1850,completed
586,rigid,5905,7720,8152,1815,432,2247,completed
587,rigid,5905,7725,17846,1820,10121,11941,completed
588,rigid,5915,7725,7732,1810,7,1817,completed
589,rigid,5915,7725,7732,1810,7,1817,completed
590,rigid,5915,7725,7732,1810,7,1817,completed
591,rigid,5915,7729,7736,1814,7,1821,completed
592,rigid,5915,7729,7736,1814,7,1821,completed
593,rigid,5915,7729,7736,1814,7,1821,completed
594,rigid,5915,7729,7736,1814,7,1821,completed
595,rigid,5915,7729,7736,1814,7,1821,completed
596,rigid,5919,7729,8544,1810,815,2625,completed
597,rigid,5919,7729,8503,1810,774,2584,completed
598,rigid,5919,7729,8595,1810,866,2676,completed
599,rigid,5919,7729,8199,1810,470,2280,completed
600,rigid,5929,7729,7797,1800,68,1868,completed
601,rigid,5929,7729,7797,1800,68,1868,completed
602,rigid,5932,7745,7881,1813,136,1949,completed
603,rigid,5932,7745,7750,1813,5,1818,completed
604,rigid,5933,7745,7755,1812,10,1822,completed
605,rigid,5933,7745,7746,1812,1,1813,completed
606,rigid,5935,7746,7747,1811,1,1812,completed
607,rigid,5935,7747,7748,1812,1,1813,completed
608,rigid,5935,7747,7851,1812,104,1916,completed
609,rigid,5936,7747,7749,1811,2,1813,completed
610,rigid,5956,7747,7998,1791,251,2042,completed
611,rigid,5956,7747,7774,1791,27,1818,completed
612,rigid,5957,7747,8535,1790,788,2578,completed
613,rigid,5957,7747,8259,1790,512,2302,completed
614,rigid,5957,7747,8693,1790,946,2736,completed
615,rigid,5962,7747,7999,1785,252,2037,completed
616,rigid,5965,7747,8013,1782,266,2048,completed
617,rigid,5965,7747,8011,1782,264,2046,completed
618,rigid,5965,7747,8010,1782,263,2045,completed
619,rigid,5965,7747,8087,1782,340,2122,completed
620,rigid,5965,7747,8093,1782,346,2128,completed
621,rigid,5965,7747,8087,1782,340,2122,completed
622,rigid,5965,7747,8088,1782,341,2123,completed
623,rigid,5965,7747,8087,1782,340,2122,completed
624,rigid,5965,7747,8172,1782,425,2207,completed
625,rigid,5966,7747,8200,1781,453,2234,completed
626,rigid,5966,7747,8200,1781,453,2234,completed
627,rigid,5966,7747,8196,1781,449,2230,completed
628,rigid,5978,7747,7754,1769,7,1776,completed
629,rigid,5978,7747,7754,1769,7,1776,completed
630,rigid,5978,7747,7754,1769,7,1776,completed
631,rigid,5978,7747,7754,1769,7,1776,completed
632,rigid,5978,7748,7755,1770,7,1777,completed
633,rigid,5978,7749,7756,1771,7,1778,completed
634,rigid,5978,7749,7756,1771,7,1778,completed
635,rigid,5978,7750,7757,1772,7,1779,completed
636,rigid,5987,7752,7770,1765,18,1783,completed
637,rigid,5992,7756,7763,1764,7,1771,completed
638,rigid,5992,7763,8195,1771,432,2203,completed
639,rigid,5992,7791,8223,1799,432,2231,completed
640,rigid,5992,7791,8223,1799,432,2231,completed
641,rigid,5992,7798,8230,1806,432,2238,completed
642,rigid,5992,7834,7997,1842,163,2005,completed
643,rigid,5993,7834,7841,1841,7,1848,completed
644,rigid,6001,7834,7836,1833,2,1835,completed
645,rigid,6001,7834,7835,1833,1,1834,completed
646,rigid,6001,7834,7835,1833,1,1834,completed
647,rigid,6001,7834,7835,1833,1,1834,completed
648,rigid,6001,7834,7835,1833,1,1834,completed
649,rigid,6001,7834,7835,1833,1,1834,completed
650,rigid,6001,7834,7850,1833,16,1849,completed
651,rigid,6001,7834,7878,1833,44,1877,completed
652,rigid,6001,7834,7835,1833,1,1834,completed
653,rigid,6001,7834,7835,1833,1,1834,completed
654,rigid,6001,7834,7848,1833,14,1847,completed
655,rigid,6001,7834,7846,1833,12,1845,completed
656,rigid,6001,7834,7844,1833,10,1843,completed
657,rigid,6001,7834,7835,1833,1,1834,completed
658,rigid,6001,7834,7882,1833,48,1881,completed
659,rigid,6001,7834,7835,1833,1,1834,completed
660,rigid,6001,7834,7835,1833,1,1834,completed
661,rigid,6001,7834,7889,1833,55,1888,completed
662,rigid,6001,7834,7849,1833,15,1848,completed
663,rigid,6001,7834,7844,1833,10,1843,completed
664,rigid,6001,7834,7845,1833,11,1844,completed
665,rigid,6001,7834,7848,1833,14,1847,completed
666,rigid,6001,7834,7847,1833,13,1846,completed
667,rigid,6001,7834,7835,1833,1,1834,completed
668,rigid,6001,7834,7835,1833,1,1834,completed
669,rigid,6001,7834,7844,1833,10,1843,completed
670,rigid,6001,7834,7845,1833,11,1844,completed
671,rigid,6001,7834,7844,1833,10,1843,completed
672,rigid,6002,7834,7835,1832,1,1833,completed
673,rigid,6002,7834,7835,1832,1,1833,completed
674,rigid,6002,7834,7847,1832,13,1845,completed
675,rigid,6002,7834,7835,1832,1,1833,completed
676,rigid,6002,7834,7835,1832,1,1833,completed
677,rigid,6002,7834,7835,1832,1,1833,completed
678,rigid,6002,7834,7844,1832,10,1842,completed
679,rigid,6002,7834,7845,1832,11,1843,completed
680,rigid,6002,7834,7835,1832,1,1833,completed
681,rigid,6002,7834,7835,1832,1,1833,completed
682,rigid,6002,7834,7835,1832,1,1833,completed
683,rigid,6002,7834,7835,1832,1,1833,completed
684,rigid,6002,7834,7844,1832,10,1842,completed
685,rigid,6002,7834,7846,1832,12,1844,completed
686,rigid,6002,7834,7846,1832,12,1844,completed
687,rigid,6002,7834,7844,1832,10,1842,completed
688,rigid,6002,7834,7835,1832,1,1833,completed
689,rigid,6002,7834,7835,1832,1,1833,completed
690,rigid,6002,7834,7850,1832,16,1848,completed
691,rigid,6002,7834,7846,1832,12,1844,completed
692,rigid,6002,7834,7881,1832,47,1879,completed
693,rigid,6002,7834,7848,1832,14,1846,completed
694,rigid,6002,7834,7843,1832,9,1841,completed
695,rigid,6002,7834,7887,1832,53,1885,completed
696,rigid,6002,7834,7848,1832,14,1846,completed
697,rigid,6002,7834,7843,1832,9,1841,completed
698,rigid,6002,7834,7848,1832,14,1846,completed
699,rigid,6002,7834,7844,1832,10,1842,completed
700,rigid,6002,7834,7880,1832,46,1878,completed
701,rigid,6002,7835,7874,1833,39,1872,completed
702,rigid,6002,7835,7871,1833,36,1869,completed
703,rigid,6002,7835,7845,1833,10,1843,completed
704,rigid,6002,7835,7848,1833,13,1846,completed
705,rigid,6002,7835,7874,1833,39,1872,completed
706,rigid,6002,7835,7845,1833,10,1843,completed
707,rigid,6002,7835,7848,1833,13,1846,completed
708,rigid,6002,7835,7875,1833,40,1873,completed
709,rigid,6002,7835,7848,1833,13,1846,completed
710,rigid,6002,7835,7873,1833,38,1871,completed
711,rigid,6002,7835,7873,1833,38,1871,completed
712,rigid,6002,7835,7848,1833,13,1846,completed
713,rigid,6002,7835,7844,1833,9,1842,completed
714,rigid,6002,7835,7844,1833,9,1842,completed
715,rigid,6002,7836,7849,1834,13,1847,completed
716,rigid,6002,7836,7849,1834,13,1847,completed
717,rigid,6002,7836,7875,1834,39,1873,completed
718,rigid,6002,7836,7846,1834,10,1844,completed
719,rigid,6002,7836,7876,1834,40,1874,completed
720,rigid,6002,7836,7848,1834,12,1846,completed
721,rigid,6002,7836,7870,1834,34,1868,completed
722,rigid,6002,7836,7849,1834,13,1847,completed
723,rigid,6002,7836,7851,1834,15,1849,completed
724,rigid,6002,7836,7846,1834,10,1844,completed
725,rigid,6002,7836,7846,1834,10,1844,completed
726,rigid,6002,7836,7849,1834,13,1847,completed
727,rigid,6002,7836,7846,1834,10,1844,completed
728,rigid,6002,7836,7875,1834,39,1873,completed
729,rigid,6002,7836,7846,1834,10,1844,completed
730,rigid,6002,7836,7849,1834,13,1847,completed
731,rigid,6002,7836,7850,1834,14,1848,completed
732,rigid,6002,7836,7842,1834,6,1840,completed
733,rigid,6002,7836,7842,1834,6,1840,completed
734,rigid,6002,7836,7857,1834,21,1855,completed
735,rigid,6002,7836,7848,1834,12,1846,completed
736,rigid,6002,7841,7847,1839,6,1845,completed
737,rigid,6002,7841,7847,1839,6,1845,completed
738,rigid,6002,7841,7862,1839,21,1860,completed
739,rigid,6002,7841,7853,1839,12,1851,completed
740,rigid,6004,7841,7848,1837,7,1844,completed
741,rigid,6009,7843,7853,1834,10,1844,completed
742,rigid,6009,7846,7850,1837,4,1841,completed
743,rigid,6017,7848,7857,1831,9,1840,completed
744,rigid,6020,7850,7855,1830,5,1835,completed
745,rigid,6025,7853,8065,1828,212,2040,completed
746,rigid,6029,7870,7874,1841,4,1845,completed
747,rigid,6034,7874,8738,1840,864,2704,completed
748,rigid,6035,7874,7879,1839,5,1844,completed
749,rigid,6041,7874,7913,1833,39,1872,completed
750,rigid,6041,7874,7875,1833,1,1834,completed
751,rigid,6047,7874,7879,1827,5,1832,completed
752,rigid,6054,7874,7875,1820,1,1821,completed
753,rigid,6056,7879,7909,1823,30,1853,completed
754,rigid,6058,7879,7880,1821,1,1822,completed
755,rigid,6059,7881,9092,1822,1211,3033,completed
756,rigid,6059,7881,9092,1822,1211,3033,completed
757,rigid,6059,7881,9092,1822,1211,3033,completed
758,rigid,6059,7882,9093,1823,1211,3034,completed
759,rigid,6059,7882,9093,1823,1211,3034,completed
760,rigid,6060,7882,7883,1822,1,1823,completed
761,rigid,6062,7882,7884,1820,2,1822,completed
762,rigid,6062,7882,7887,1820,5,1825,completed
763,rigid,6063,7899,9619,1836,1720,3556,completed
764,rigid,6065,7899,7900,1834,1,1835,completed
765,rigid,6068,7899,7900,1831,1,1832,completed
766,rigid,6070,7899,7901,1829,2,1831,completed
767,rigid,6073,7899,7903,1826,4,1830,completed
768,rigid,6073,7899,7904,1826,5,1831,completed
769,rigid,6074,7899,7900,1825,1,1826,completed
770,rigid,6077,7920,9641,1843,1721,3564,completed
771,rigid,6077,7920,7922,1843,2,1845,completed
772,rigid,6079,7935,7940,1856,5,1861,completed
773,rigid,6080,7935,7937,1855,2,1857,completed
774,rigid,6081,7937,9659,1856,1722,3578,completed
775,rigid,6083,7940,9661,1857,1721,3578,completed
776,rigid,6084,7940,7941,1856,1,1857,completed
777,rigid,6085,7940,7945,1855,5,1860,completed
778,rigid,6086,7940,7942,1854,2,1856,completed
779,rigid,6088,7940,7943,1852,3,1855,completed
780,rigid,6089,7940,7950,1851,10,1861,completed
781,rigid,6090,7940,7941,1850,1,1851,completed
782,rigid,6091,7940,7943,1849,3,1852,completed
783,rigid,6091,7943,7961,1852,18,1870,completed
784,rigid,6093,7943,7945,1850,2,1852,completed
785,rigid,6095,7943,7951,1848,8,1856,completed
786,rigid,6096,7943,7945,1847,2,1849,completed
787,rigid,6096,7943,7945,1847,2,1849,completed
788,rigid,6096,7943,7945,1847,2,1849,completed
789,rigid,6096,7943,7946,1847,3,1850,completed
790,rigid,6096,7943,7945,1847,2,1849,completed
791,rigid,6096,7943,7946,1847,3,1850,completed
792,rigid,6096,7943,7945,1847,2,1849,completed
793,rigid,6096,7943,7945,1847,2,1849,completed
794,rigid,6096,7943,7945,1847,2,1849,completed
795,rigid,6096,7943,7946,1847,3,1850,completed
796,rigid,6096,7943,7945,1847,2,1849,completed
797,rigid,6096,7943,7945,1847,2,1849,completed
798,rigid,6096,7943,7945,1847,2,1849,completed
799,rigid,6096,7943,7945,1847,2,1849,completed
800,rigid,6096,7943,7945,1847,2,1849,completed
801,rigid,6096,7943,7945,1847,2,1849,completed
802,rigid,6096,7943,7946,1847,3,1850,completed
803,rigid,6096,7943,7946,1847,3,1850,completed
804,rigid,6096,7943,7945,1847,2,1849,completed
805,rigid,6096,7943,7945,1847,2,1849,completed
806,rigid,6096,7943,7945,1847,2,1849,completed
807,rigid,6096,7943,7945,1847,2,1849,completed
808,rigid,6096,7943,7945,1847,2,1849,completed
809,rigid,6096,7943,7945,1847,2,1849,completed
810,rigid,6096,7943,7945,1847,2,1849,completed
811,rigid,6096,7943,7945,1847,2,1849,completed
812,rigid,6096,7943,7946,1847,3,1850,completed
813,rigid,6096,7943,7945,1847,2,1849,completed
814,rigid,6096,7943,7945,1847,2,1849,completed
815,rigid,6096,7943,7946,1847,3,1850,completed
816,rigid,6096,7943,7946,1847,3,1850,completed
817,rigid,6096,7943,7945,1847,2,1849,completed
818,rigid,6096,7943,7945,1847,2,1849,completed
819,rigid,6096,7943,7946,1847,3,1850,completed
820,rigid,6096,7943,7946,1847,3,1850,completed
821,rigid,6096,7943,7946,1847,3,1850,completed
822,rigid,6096,7943,7945,1847,2,1849,completed
823,rigid,6096,7943,7945,1847,2,1849,completed
824,rigid,6096,7943,7945,1847,2,1849,completed
825,rigid,6096,7943,7946,1847,3,1850,completed
826,rigid,6096,7943,7946,1847,3,1850,completed
827,rigid,6096,7943,7946,1847,3,1850,completed
828,rigid,6096,7943,7946,1847,3,1850,completed
829,rigid,6096,7943,7946,1847,3,1850,completed
830,rigid,6096,7943,7945,1847,2,1849,completed
831,rigid,6096,7943,7945,1847,2,1849,completed
832,rigid,6096,7943,7945,1847,2,1849,completed
833,rigid,6096,7943,7946,1847,3,1850,completed
834,rigid,6096,7943,7946,1847,3,1850,completed
835,rigid,6096,7943,7945,1847,2,1849,completed
836,rigid,6096,7945,7947,1849,2,1851,completed
837,rigid,6096,7945,7947,1849,2,1851,completed
838,rigid,6096,7945,7947,1849,2,1851,completed
839,rigid,6096,7945,7947,1849,2,1851,completed
840,rigid,6096,7945,7948,1849,3,1852,completed
841,rigid,6096,7945,7948,1849,3,1852,completed
842,rigid,6096,7945,7948,1849,3,1852,completed
843,rigid,6096,7945,7948,1849,3,1852,completed
844,rigid,6096,7945,7948,1849,3,1852,completed
845,rigid,6096,7945,7948,1849,3,1852,completed
846,rigid,6096,7945,7948,1849,3,1852,completed
847,rigid,6096,7945,7947,1849,2,1851,completed
848,rigid,6096,7945,7947,1849,2,1851,completed
849,rigid,6096,7945,7947,1849,2,1851,completed
850,rigid,6096,7945,7947,1849,2,1851,completed
851,rigid,6096,7945,7947,1849,2,1851,completed
852,rigid,6096,7945,7947,1849,2,1851,completed
853,rigid,6096,7945,7947,1849,2,1851,completed
854,rigid,6096,7945,7948,1849,3,1852,completed
855,rigid,6096,7945,7947,1849,2,1851,completed
856,rigid,6096,7945,7948,1849,3,1852,completed
857,rigid,6096,7945,7948,1849,3,1852,completed
858,rigid,6096,7945,7947,1849,2,1851,completed
859,rigid,6096,7945,7947,1849,2,1851,completed
860,rigid,6096,7945,7947,1849,2,1851,completed
861,rigid,6096,7945,7947,1849,2,1851,completed
862,rigid,6096,7945,7947,1849,2,1851,completed
863,rigid,6096,7945,7947,1849,2,1851,completed
864,rigid,6096,7945,7947,1849,2,1851,completed
865,rigid,6096,7945,7947,1849,2,1851,completed
866,rigid,6096,7945,7947,1849,2,1851,completed
867,rigid,6096,7945,7947,1849,2,1851,completed
868,rigid,6096,7945,7947,1849,2,1851,completed
869,rigid,6096,7945,7947,1849,2,1851,completed
870,rigid,6096,7945,7947,1849,2,1851,completed
871,rigid,6096,7945,7947,1849,2,1851,completed
872,rigid,6096,7945,7947,1849,2,1851,completed
873,rigid,6096,7945,7947,1849,2,1851,completed
874,rigid,6096,7945,7947,1849,2,1851,completed
875,rigid,6096,7945,7947,1849,2,1851,completed
876,rigid,6096,7945,7947,1849,2,1851,completed
877,rigid,6096,7945,7947,1849,2,1851,completed
878,rigid,6096,7945,7947,1849,2,1851,completed
879,rigid,6096,7945,7947,1849,2,1851,completed
880,rigid,6099,7945,7947,1846,2,1848,completed
881,rigid,6099,7945,7947,1846,2,1848,completed
882,rigid,6099,7945,7947,1846,2,1848,completed
883,rigid,6099,7945,7947,1846,2,1848,completed
884,rigid,6099,7945,7947,1846,2,1848,completed
885,rigid,6099,7945,7947,1846,2,1848,completed
886,rigid,6099,7945,7947,1846,2,1848,completed
887,rigid,6099,7945,7947,1846,2,1848,completed
888,rigid,6099,7945,7947,1846,2,1848,completed
889,rigid,6099,7945,7947,1846,2,1848,completed
890,rigid,6099,7945,7947,1846,2,1848,completed
891,rigid,6099,7945,7947,1846,2,1848,completed
892,rigid,6099,7945,7947,1846,2,1848,completed
893,rigid,6099,7945,7947,1846,2,1848,completed
894,rigid,6099,7945,7947,1846,2,1848,completed
895,rigid,6099,7945,7947,1846,2,1848,completed
896,rigid,6099,7945,7947,1846,2,1848,completed
897,rigid,6099,7945,7947,1846,2,1848,completed
898,rigid,6099,7945,7947,1846,2,1848,completed
899,rigid,6099,7945,7947,1846,2,1848,completed
900,rigid,6099,7945,7947,1846,2,1848,completed
901,rigid,6099,7945,7947,1846,2,1848,completed
902,rigid,6099,7945,7947,1846,2,1848,completed
903,rigid,6099,7945,7947,1846,2,1848,completed
904,rigid,6099,7945,7947,1846,2,1848,completed
905,rigid,6099,7946,7948,1847,2,1849,completed
906,rigid,6099,7946,7948,1847,2,1849,completed
907,rigid,6099,7946,7948,1847,2,1849,completed
908,rigid,6099,7946,7948,1847,2,1849,completed
909,rigid,6099,7946,7948,1847,2,1849,completed
910,rigid,6099,7946,7948,1847,2,1849,completed
911,rigid,6099,7946,7948,1847,2,1849,completed
912,rigid,6099,7946,7948,1847,2,1849,completed
913,rigid,6099,7946,7948,1847,2,1849,completed
914,rigid,6099,7946,7948,1847,2,1849,completed
915,rigid,6099,7946,7948,1847,2,1849,completed
916,rigid,6099,7946,7948,1847,2,1849,completed
917,rigid,6099,7946,7948,1847,2,1849,completed
918,rigid,6099,7946,7948,1847,2,1849,completed
919,rigid,6099,7946,7948,1847,2,1849,completed
920,rigid,6099,7946,7948,1847,2,1849,completed
921,rigid,6099,7946,7948,1847,2,1849,completed
922,rigid,6099,7946,7948,1847,2,1849,completed
923,rigid,6099,7946,7948,1847,2,1849,completed
924,rigid,6099,7946,7948,1847,2,1849,completed
925,rigid,6099,7946,7948,1847,2,1849,completed
926,rigid,6099,7946,7948,1847,2,1849,completed
927,rigid,6099,7946,7948,1847,2,1849,completed
928,rigid,6099,7946,7948,1847,2,1849,completed
929,rigid,6099,7946,7948,1847,2,1849,completed
930,rigid,6099,7946,7948,1847,2,1849,completed
931,rigid,6099,7946,7948,1847,2,1849,completed
932,rigid,6099,7946,7948,1847,2,1849,completed
933,rigid,6099,7946,7948,1847,2,1849,completed
934,rigid,6099,7946,7948,1847,2,1849,completed
935,rigid,6099,7946,7948,1847,2,1849,completed
936,rigid,6099,7946,7948,1847,2,1849,completed
937,rigid,6099,7946,7948,1847,2,1849,completed
938,rigid,6099,7946,7948,1847,2,1849,completed
939,rigid,6099,7946,7948,1847,2,1849,completed
940,rigid,6099,7946,7948,1847,2,1849,completed
941,rigid,6099,7946,7948,1847,2,1849,completed
942,rigid,6099,7946,7948,1847,2,1849,completed
943,rigid,6099,7946,7948,1847,2,1849,completed
944,rigid,6099,7946,7948,1847,2,1849,completed
945,rigid,6099,7946,7948,1847,2,1849,completed
946,rigid,6099,7946,7948,1847,2,1849,completed
947,rigid,6099,7946,7948,1847,2,1849,completed
948,rigid,6099,7946,7948,1847,2,1849,completed
949,rigid,6099,7946,7948,1847,2,1849,completed
950,rigid,6099,7946,7948,1847,2,1849,completed
951,rigid,6099,7946,7948,1847,2,1849,completed
952,rigid,6099,7946,7948,1847,2,1849,completed
953,rigid,6099,7946,7948,1847,2,1849,completed
954,rigid,6099,7946,7948,1847,2,1849,completed
955,rigid,6099,7946,7948,1847,2,1849,completed
956,rigid,6099,7946,7948,1847,2,1849,completed
957,rigid,6099,7946,7948,1847,2,1849,completed
958,rigid,6099,7946,7948,1847,2,1849,completed
959,rigid,6099,7946,7948,1847,2,1849,completed
960,rigid,6099,7946,7948,1847,2,1849,completed
961,rigid,6099,7946,7948,1847,2,1849,completed
962,rigid,6099,7946,7948,1847,2,1849,completed
963,rigid,6099,7946,7948,1847,2,1849,completed
964,rigid,6099,7946,7948,1847,2,1849,completed
965,rigid,6099,7946,7948,1847,2,1849,completed
966,rigid,6099,7946,7948,1847,2,1849,completed
967,rigid,6099,7946,7948,1847,2,1849,completed
968,rigid,6099,7946,7948,1847,2,1849,completed
969,rigid,6099,7946,7948,1847,2,1849,completed
970,rigid,6099,7946,7948,1847,2,1849,completed
971,rigid,6099,7946,7948,1847,2,1849,completed
972,rigid,6099,7946,7948,1847,2,1849,completed
973,rigid,6099,7946,7948,1847,2,1849,completed
974,rigid,6099,7946,7948,1847,2,1849,completed
975,rigid,6099,7946,7948,1847,2,1849,completed
976,rigid,6099,7946,7947,1847,1,1848,completed
977,rigid,6099,7946,7948,1847,2,1849,completed
978,rigid,6099,7946,7948,1847,2,1849,completed
979,rigid,6099,7946,7948,1847,2,1849,completed
980,rigid,6099,7946,7948,1847,2,1849,completed
981,rigid,6099,7948,9257,1849,1309,3158,completed
982,rigid,6104,7950,8382,1846,432,2278,completed
983,rigid,6144,7997,8429,1853,432,2285,completed
984,rigid,6144,8013,8445,1869,432,2301,completed
985,rigid,6144,8195,8627,2051,432,2483,completed
986,rigid,6144,8223,8655,2079,432,2511,completed
987,rigid,6144,8223,8655,2079,432,2511,completed
988,rigid,6144,8230,8662,2086,432,2518,completed
989,rigid,6176,8230,8236,2054,6,2060,completed
990,rigid,6185,8230,8237,2045,7,2052,completed
991,rigid,6194,8230,8263,2036,33,2069,completed
992,rigid,6257,8230,8235,1973,5,1978,completed
993,rigid,6262,8230,8231,1968,1,1969,completed
994,rigid,6262,8230,8231,1968,1,1969,completed
995,rigid,6262,8230,8231,1968,1,1969,completed
996,rigid,6262,8230,8231,1968,1,1969,completed
997,rigid,6262,8230,8232,1968,2,1970,completed
998,rigid,6263,8230,8237,1967,7,1974,completed
999,rigid,6301,8230,9930,1929,1700,3629,completed
1000,rigid,6311,8235,8240,1924,5,1929,completed
1001,rigid,6315,8236,8237,1921,1,1922,completed
1002,rigid,6323,8237,9936,1914,1699,3613,completed
1003,rigid,6329,8240,9968,1911,1728,3639,completed
1004,rigid,6331,8240,9968,1909,1728,3637,completed
1005,rigid,6360,8240,10357,1880,2117,3997,completed
1006,rigid,6540,8280,9023,1740,743,2483,completed
1007,rigid,6600,8280,8282,1680,2,1682,completed
1008,rigid,6706,8282,8300,1576,18,1594,completed
1009,rigid,6735,8300,9226,1565,926,2491,completed
1010,rigid,6735,8300,8443,1565,143,1708,completed
1011,rigid,6735,8382,8520,1647,138,1785,completed
1012,rigid,6736,8415,9319,1679,904,2583,completed
1013,rigid,6736,8429,9338,1693,909,2602,completed
1014,rigid,6736,8429,9188,1693,759,2452,completed
1015,rigid,6736,8429,9318,1693,889,2582,completed
1016,rigid,6736,8429,9129,1693,700,2393,completed
1017,rigid,6736,8429,9410,1693,981,2674,completed
1018,rigid,6737,8429,9215,1692,786,2478,completed
1019,rigid,6737,8429,9349,1692,920,2612,completed
1020,rigid,6737,8429,8458,1692,29,1721,completed
1021,rigid,6753,8443,9376,1690,933,2623,completed
1022,rigid,6753,8445,9243,1692,798,2490,completed
1023,rigid,6753,8445,9088,1692,643,2335,completed
1024,rigid,6753,8445,9299,1692,854,2546,completed
1025,rigid,6753,8503,9362,1750,859,2609,completed
1026,rigid,6753,8544,9396,1791,852,2643,completed
1027,rigid,6753,8546,9115,1793,569,2362,completed
1028,rigid,6753,8546,9114,1793,568,2361,completed
1029,rigid,6753,8627,9480,1874,853,2727,completed
1030,rigid,6754,8627,9319,1873,692,2565,completed
1031,rigid,6754,8655,9346,1901,691,2592,completed
1032,rigid,6754,8655,9348,1901,693,2594,completed
1033,rigid,6754,8655,9508,1901,853,2754,completed
1034,rigid,6754,8662,9246,1908,584,2492,completed
1035,rigid,6754,8677,9531,1923,854,2777,completed
1036,rigid,6754,8777,9429,2023,652,2675,completed
1037,rigid,6754,8808,9456,2054,648,2702,completed
1038,rigid,6754,8811,9458,2057,647,2704,completed
1039,rigid,6755,8811,10539,2056,1728,3784,completed
1040,rigid,6755,8811,9961,2056,1150,3206,completed
1041,rigid,6755,8811,9769,2056,958,3014,completed
1042,rigid,6758,8811,10539,2053,1728,3781,completed
1043,rigid,6758,8811,10539,2053,1728,3781,completed
1044,rigid,6758,8811,10539,2053,1728,3781,completed
1045,rigid,6759,8811,10539,2052,1728,3780,completed
1046,rigid,6759,8811,10539,2052,1728,3780,completed
1047,rigid,6759,8811,10539,2052,1728,3780,completed
1048,rigid,6764,8811,10539,2047,1728,3775,completed
1049,rigid,6764,8811,10539,2047,1728,3775,completed
1050,rigid,6764,8811,10539,2047,1728,3775,completed
1051,rigid,6765,8811,10539,2046,1728,3774,completed
1052,rigid,6765,8811,10539,2046,1728,3774,completed
1053,rigid,6765,8811,10539,2046,1728,3774,completed
1054,rigid,6766,8811,10539,2045,1728,3773,completed
1055,rigid,6766,8811,10539,2045,1728,3773,completed
1056,rigid,6766,8811,10539,2045,1728,3773,completed
1057,rigid,6771,8811,9675,2040,864,2904,completed
1058,rigid,6777,8811,8831,2034,20,2054,completed
1059,rigid,6777,8811,9243,2034,432,2466,completed
1060,rigid,6785,8813,10195,2028,1382,3410,completed
1061,rigid,6785,8813,10064,2028,1251,3279,completed
1062,rigid,6785,8813,8814,2028,1,2029,completed
1063,rigid,6785,8813,9034,2028,221,2249,completed
1064,rigid,6785,8814,9009,2029,195,2224,completed
1065,rigid,6785,8822,9040,2037,218,2255,completed
1066,rigid,6785,8822,9273,2037,451,2488,completed
1067,rigid,6785,8824,9031,2039,207,2246,completed
1068,rigid,6785,8824,9046,2039,222,2261,completed
1069,rigid,6785,8829,10832,2044,2003,4047,completed
1070,rigid,6785,8829,10180,2044,1351,3395,completed
1071,rigid,6785,8829,8936,2044,107,2151,completed
1072,rigid,6785,8831,11423,2046,2592,4638,completed
1073,rigid,6785,8842,10582,2057,1740,3797,completed
1074,rigid,6785,8842,9695,2057,853,2910,completed
1075,rigid,6785,8842,10571,2057,1729,3786,completed
1076,rigid,6785,8842,9123,2057,281,2338,completed
1077,rigid,6785,8843,9526,2058,683,2741,completed
1078,rigid,6785,8843,11435,2058,2592,4650,completed
1079,rigid,6785,8843,9627,2058,784,2842,completed
1080,rigid,6785,8843,9783,2058,940,2998,completed
1081,rigid,6785,8847,8983,2062,136,2198,completed
1082,rigid,6785,8847,9424,2062,577,2639,completed
1083,rigid,6785,8847,8883,2062,36,2098,completed
1084,rigid,6785,8847,11439,2062,2592,4654,completed
1085,rigid,6785,8852,8918,2067,66,2133,completed
1086,rigid,6785,8852,11444,2067,2592,4659,completed
1087,rigid,6785,8852,9026,2067,174,2241,completed
1088,rigid,6785,8852,9957,2067,1105,3172,completed
1089,rigid,6785,8866,9037,2081,171,2252,completed
1090,rigid,6785,8866,8891,2081,25,2106,completed
1091,rigid,6785,8866,11458,2081,2592,4673,completed
1092,rigid,6785,8866,8912,2081,46,2127,completed
1093,rigid,6785,8866,9123,2081,257,2338,completed
1094,rigid,6785,8866,11458,2081,2592,4673,completed
1095,rigid,6785,8866,11458,2081,2592,4673,completed
1096,rigid,6785,8866,10230,2081,1364,3445,completed
1097,rigid,6785,8866,11458,2081,2592,4673,completed
1098,rigid,6785,8866,11458,2081,2592,4673,completed
1099,rigid,6785,8872,10233,2087,1361,3448,completed
1100,rigid,6785,8872,8914,2087,42,2129,completed
1101,rigid,6785,8872,9116,2087,244,2331,completed
1102,rigid,6785,8872,9158,2087,286,2373,completed
1103,rigid,6785,8883,8996,2098,113,2211,completed
1104,rigid,6785,8885,9572,2100,687,2787,completed
1105,rigid,6785,8885,9502,2100,617,2717,completed
1106,rigid,6785,8885,9044,2100,159,2259,completed
1107,rigid,6785,8885,9027,2100,142,2242,completed
1108,rigid,6785,8885,10334,2100,1449,3549,completed
1109,rigid,6785,8885,9244,2100,359,2459,completed
1110,rigid,6785,8885,11122,2100,2237,4337,completed
1111,rigid,6785,8885,9785,2100,900,3000,completed
1112,rigid,6785,8885,10448,2100,1563,3663,completed
1113,rigid,6785,8885,10300,2100,1415,3515,completed
1114,rigid,6785,8891,11483,2106,2592,4698,completed
1115,rigid,6785,8912,11504,2127,2592,4719,completed
1116,rigid,6785,8914,8983,2129,69,2198,completed
1117,rigid,6785,8918,9526,2133,608,2741,completed
1118,rigid,6785,8936,11528,2151,2592,4743,completed
1119,rigid,6785,8983,11575,2198,2592,4790,completed
1120,rigid,6785,8983,8991,2198,8,2206,completed
1121,rigid,6785,8991,9139,2206,148,2354,completed
1122,rigid,6785,8996,9142,2211,146,2357,completed
1123,rigid,6785,9009,11601,2224,2592,4816,completed
1124,rigid,6785,9023,11615,2238,2592,4830,completed
1125,rigid,6785,9023,11615,2238,2592,4830,completed
1126,rigid,6785,9023,11615,2238,2592,4830,completed
1127,rigid,6785,9023,9921,2238,898,3136,completed
1128,rigid,6785,9026,11618,2241,2592,4833,completed
1129,rigid,6785,9027,9274,2242,247,2489,completed
1130,rigid,6785,9031,9389,2246,358,2604,completed
1131,rigid,6785,9034,9814,2249,780,3029,completed
1132,rigid,6785,9037,9539,2252,502,2754,completed
1133,rigid,6785,9040,9217,2255,177,2432,completed
1134,rigid,6785,9044,9876,2259,832,3091,completed
1135,rigid,6785,9046,9365,2261,319,2580,completed
1136,rigid,6785,9081,9798,2296,717,3013,completed
1137,rigid,6785,9081,9680,2296,599,2895,completed
1138,rigid,6785,9081,9314,2296,233,2529,completed
1139,rigid,6785,9086,9311,2301,225,2526,completed
1140,rigid,6785,9086,9410,2301,324,2625,completed
1141,rigid,6785,9086,11678,2301,2592,4893,completed
1142,rigid,6785,9086,11109,2301,2023,4324,completed
1143,rigid,6785,9088,10987,2303,1899,4202,completed
1144,rigid,6785,9092,9904,2307,812,3119,completed
1145,rigid,6785,9092,10084,2307,992,3299,completed
1146,rigid,6785,9092,10081,2307,989,3296,completed
1147,rigid,6785,9092,9692,2307,600,2907,completed
1148,rigid,6785,9092,9551,2307,459,2766,completed
1149,rigid,6785,9092,9653,2307,561,2868,completed
1150,rigid,6785,9092,9301,2307,209,2516,completed
1151,rigid,6785,9092,11684,2307,2592,4899,completed
1152,rigid,6785,9092,11684,2307,2592,4899,completed
1153,rigid,6785,9093,11685,2308,2592,4900,completed
1154,rigid,6785,9093,9694,2308,601,2909,completed
1155,rigid,6785,9093,11685,2308,2592,4900,completed
1156,rigid,6785,9093,11685,2308,2592,4900,completed
1157,rigid,6785,9114,10252,2329,1138,3467,completed
1158,rigid,6785,9114,9437,2329,323,2652,completed
1159,rigid,6785,9114,9514,2329,400,2729,completed
1160,rigid,6785,9115,11707,2330,2592,4922,completed
1161,rigid,6785,9115,11707,2330,2592,4922,completed
1162,rigid,6785,9115,10871,2330,1756,4086,completed
1163,rigid,6785,9123,11715,2338,2592,4930,completed
1164,rigid,6785,9129,10292,2344,1163,3507,completed
1165,rigid,6785,9142,9781,2357,639,2996,completed
1166,rigid,6785,9169,11761,2384,2592,4976,completed
1167,rigid,6785,9169,9988,2384,819,3203,completed
1168,rigid,6785,9169,9188,2384,19,2403,completed
1169,rigid,6785,9188,9220,2403,32,2435,completed
1170,rigid,6785,9188,9211,2403,23,2426,completed
1171,rigid,6785,9211,9469,2426,258,2684,completed
1172,rigid,6785,9215,9470,2430,255,2685,completed
1173,rigid,6785,9217,9341,2432,124,2556,completed
1174,rigid,6785,9220,10630,2435,1410,3845,completed
1175,rigid,6785,9226,9751,2441,525,2966,completed
1176,rigid,6785,9243,11835,2458,2592,5050,completed
1177,rigid,6785,9243,11835,2458,2592,5050,completed
1178,rigid,6785,9244,10425,2459,1181,3640,completed
1179,rigid,6785,9246,9591,2461,345,2806,completed
1180,rigid,6785,9246,9604,2461,358,2819,completed
1181,rigid,6785,9246,10280,2461,1034,3495,completed
1182,rigid,6785,9246,11838,2461,2592,5053,completed
1183,rigid,6785,9246,9395,2461,149,2610,completed
1184,rigid,6785,9246,9517,2461,271,2732,completed
1185,rigid,6785,9257,9447,2472,190,2662,completed
1186,rigid,6785,9257,9453,2472,196,2668,completed
1187,rigid,6785,9257,9393,2472,136,2608,completed
1188,rigid,6785,9257,11849,2472,2592,5064,completed
1189,rigid,6785,9257,9358,2472,101,2573,completed
1190,rigid,6785,9257,9890,2472,633,3105,completed
1191,rigid,6785,9257,9351,2472,94,2566,completed
1192,rigid,6785,9257,9346,2472,89,2561,completed
1193,rigid,6785,9257,9479,2472,222,2694,completed
1194,rigid,6785,9257,9339,2472,82,2554,completed
1195,rigid,6785,9257,11849,2472,2592,5064,completed
1196,rigid,6785,9257,9310,2472,53,2525,completed
1197,rigid,6785,9273,9378,2488,105,2593,completed
1198,rigid,6785,9274,11866,2489,2592,5081,completed
1199,rigid,6790,9299,9385,2509,86,2595,completed
1200,rigid,6792,9299,9731,2507,432,2939,completed
1201,rigid,6793,9299,9731,2506,432,2938,completed
1202,rigid,6818,9301,9913,2483,612,3095,completed
1203,rigid,6818,9301,9787,2483,486,2969,completed
1204,rigid,6818,9310,9766,2492,456,2948,completed
1205,rigid,6834,9311,9408,2477,97,2574,completed
1206,rigid,6834,9314,10689,2480,1375,3855,completed
1207,rigid,6834,9318,9763,2484,445,2929,completed
1208,rigid,6836,9319,10231,2483,912,3395,completed
1209,rigid,6836,9319,10243,2483,924,3407,completed
1210,rigid,6836,9319,11047,2483,1728,4211,completed
1211,rigid,6837,9319,9792,2482,473,2955,completed
1212,rigid,6837,9319,9755,2482,436,2918,completed
1213,rigid,6837,9319,9884,2482,565,3047,completed
1214,rigid,6852,9319,9321,2467,2,2469,completed
1215,rigid,6856,9319,9320,2463,1,2464,completed
1216,rigid,6861,9338,9340,2477,2,2479,completed
1217,rigid,6878,9340,9341,2462,1,2463,completed
1218,rigid,6896,9340,9394,2444,54,2498,completed
1219,rigid,6911,9341,9762,2430,421,2851,completed
1220,rigid,6912,9341,9344,2429,3,2432,completed
1221,rigid,6914,9344,9346,2430,2,2432,completed
1222,rigid,6915,9346,9347,2431,1,2432,completed
1223,rigid,6916,9346,9372,2430,26,2456,completed
1224,rigid,6918,9346,10178,2428,832,3260,completed
1225,rigid,6918,9346,10047,2428,701,3129,completed
1226,rigid,6918,9346,11065,2428,1719,4147,completed
1227,rigid,6918,9346,9452,2428,106,2534,completed
1228,rigid,6919,9346,9551,2427,205,2632,completed
1229,rigid,6919,9346,9347,2427,1,2428,completed
1230,rigid,6919,9346,9347,2427,1,2428,completed
1231,rigid,6919,9346,9347,2427,1,2428,completed
1232,rigid,6919,9346,9347,2427,1,2428,completed
1233,rigid,6919,9346,9347,2427,1,2428,completed
1234,rigid,6919,9346,9351,2427,5,2432,completed
1235,rigid,6920,9347,9779,2427,432,2859,completed
1236,rigid,6920,9347,9779,2427,432,2859,completed
1237,rigid,6921,9348,9366,2427,18,2445,completed
1238,rigid,6921,9348,10352,2427,1004,3431,completed
1239,rigid,6921,9348,10075,2427,727,3154,completed
1240,rigid,6922,9348,10665,2426,1317,3743,completed
1241,rigid,6922,9348,10242,2426,894,3320,completed
1242,rigid,6922,9348,10262,2426,914,3340,completed
1243,rigid,6925,9349,10199,2424,850,3274,completed
1244,rigid,6925,9351,11079,2426,1728,4154,completed
1245,rigid,6925,9358,9997,2433,639,3072,completed
1246,rigid,6925,9362,9460,2437,98,2535,completed
1247,rigid,6925,9362,10002,2437,640,3077,completed
1248,rigid,6925,9362,11090,2437,1728,4165,completed
1249,rigid,6925,9362,10313,2437,951,3388,completed
1250,rigid,6925,9365,10580,2440,1215,3655,completed
1251,rigid,6925,9366,10609,2441,1243,3684,completed
1252,rigid,6927,9372,11100,2445,1728,4173,completed
1253,rigid,6927,9376,11104,2449,1728,4177,completed
1254,rigid,6927,9378,11106,2451,1728,4179,completed
1255,rigid,6927,9385,11113,2458,1728,4186,completed
1256,rigid,6927,9389,11117,2462,1728,4190,completed
1257,rigid,6927,9393,11121,2466,1728,4194,completed
1258,rigid,6935,9394,9500,2459,106,2565,completed
1259,rigid,6940,9394,9395,2454,1,2455,completed
1260,rigid,6940,9395,9396,2455,1,2456,completed
1261,rigid,6940,9395,9396,2455,1,2456,completed
1262,rigid,6940,9395,9397,2455,2,2457,completed
1263,rigid,6940,9395,9396,2455,1,2456,completed
1264,rigid,6940,9395,9396,2455,1,2456,completed
1265,rigid,6940,9395,9396,2455,1,2456,completed
1266,rigid,7023,9456,10938,2433,1482,3915,completed
1267,rigid,7064,9456,9542,2392,86,2478,completed
1268,rigid,7099,9456,9512,2357,56,2413,completed
1269,rigid,7099,9458,9518,2359,60,2419,completed
1270,rigid,7099,9458,9519,2359,61,2420,completed
1271,rigid,7099,9458,9519,2359,61,2420,completed
1272,rigid,7132,9458,9460,2326,2,2328,completed
1273,rigid,7136,9460,9463,2324,3,2327,completed
1274,rigid,7142,9460,9462,2318,2,2320,completed
1275,rigid,7145,9462,9466,2317,4,2321,completed
1276,rigid,7149,9463,9465,2314,2,2316,completed
1277,rigid,7152,9465,9468,2313,3,2316,completed
1278,rigid,7159,9466,9472,2307,6,2313,completed
1279,rigid,7166,9468,9471,2302,3,2305,completed
1280,rigid,7169,9469,9478,2300,9,2309,completed
1281,rigid,7184,9470,9475,2286,5,2291,completed
1282,rigid,7189,9471,9476,2282,5,2287,completed
1283,rigid,7195,9472,9474,2277,2,2279,completed
1284,rigid,7199,9474,9478,2275,4,2279,completed
1285,rigid,7204,9475,9482,2271,7,2278,completed
1286,rigid,7212,9476,9482,2264,6,2270,completed
1287,rigid,7224,9478,9480,2254,2,2256,completed
1288,rigid,7226,9480,11208,2254,1728,3982,completed
1289,rigid,7228,9480,11208,2252,1728,3980,completed
1290,rigid,7229,9482,11210,2253,1728,3981,completed
1291,rigid,7229,9482,9487,2253,5,2258,completed
1292,rigid,7232,9487,10041,2255,554,2809,completed
1293,rigid,7235,9500,9932,2265,432,2697,completed
1294,rigid,7236,9502,9648,2266,146,2412,completed
1295,rigid,7404,9508,12515,2104,3007,5111,completed
1296,rigid,7407,9512,9521,2105,9,2114,completed
1297,rigid,7421,9512,9515,2091,3,2094,completed
1298,rigid,7432,9514,9523,2082,9,2091,completed
1299,rigid,7442,9514,9541,2072,27,2099,completed
1300,rigid,7455,9518,10267,2063,749,2812,completed
1301,rigid,7455,9519,9858,2064,339,2403,completed
1302,rigid,7466,9531,10100,2065,569,2634,completed
1303,rigid,7477,9541,15241,2064,5700,7764,completed
1304,rigid,7477,9551,15715,2074,6164,8238,completed
1305,rigid,7478,9619,15914,2141,6295,8436,completed
1306,rigid,7478,9619,16488,2141,6869,9010,completed
1307,rigid,7478,9619,15145,2141,5526,7667,completed
1308,rigid,7478,9641,15713,2163,6072,8235,completed
1309,rigid,7478,9641,15073,2163,5432,7595,completed
1310,rigid,7478,9641,15029,2163,5388,7551,completed
1311,rigid,7478,9659,15206,2181,5547,7728,completed
1312,rigid,7478,9659,14960,2181,5301,7482,completed
1313,rigid,7478,9659,16309,2181,6650,8831,completed
1314,rigid,7478,9661,15939,2183,6278,8461,completed
1315,rigid,7478,9661,15522,2183,5861,8044,completed
1316,rigid,7478,9665,15304,2187,5639,7826,completed
1317,rigid,7478,9680,14860,2202,5180,7382,completed
1318,rigid,7478,9695,14248,2217,4553,6770,completed
1319,rigid,7492,9731,9732,2239,1,2240,completed
1320,rigid,7502,9731,9781,2229,50,2279,completed
1321,rigid,7509,9731,9744,2222,13,2235,completed
1322,rigid,7514,9742,12619,2228,2877,5105,completed
1323,rigid,7531,9742,9760,2211,18,2229,completed
1324,rigid,7532,9744,9753,2212,9,2221,completed
1325,rigid,7536,9751,9752,2215,1,2216,completed
1326,rigid,7536,9752,9753,2216,1,2217,completed
1327,rigid,7540,9753,9754,2213,1,2214,completed
1328,rigid,7541,9753,9754,2212,1,2213,completed
1329,rigid,7555,9754,9756,2199,2,2201,completed
1330,rigid,7563,9754,9762,2191,8,2199,completed
1331,rigid,7564,9755,11228,2191,1473,3664,completed
1332,rigid,7564,9756,10618,2192,862,3054,completed
1333,rigid,7564,9760,10299,2196,539,2735,completed
1334,rigid,7564,9762,9780,2198,18,2216,completed
1335,rigid,7564,9762,9769,2198,7,2205,completed
1336,rigid,7565,9762,9867,2197,105,2302,completed
1337,rigid,7565,9763,10627,2198,864,3062,completed
1338,rigid,7565,9766,10259,2201,493,2694,completed
1339,rigid,7568,9769,9802,2201,33,2234,completed
1340,rigid,7573,9769,9811,2196,42,2238,completed
1341,rigid,7586,9781,10349,2195,568,2763,completed
1342,rigid,7593,9811,12699,2218,2888,5106,completed
1343,rigid,7594,9858,12887,2264,3029,5293,completed
1344,rigid,7594,9904,12798,2310,2894,5204,completed
1345,rigid,7594,9936,12895,2342,2959,5301,completed
1346,rigid,7594,10002,13256,2408,3254,5662,completed
1347,rigid,7594,10047,10064,2453,17,2470,completed
1348,rigid,7595,10075,11567,2480,1492,3972,completed
1349,rigid,7604,10081,11809,2477,1728,4205,completed
1350,rigid,7604,10084,11812,2480,1728,4208,completed
1351,rigid,7605,10100,11828,2495,1728,4223,completed
1352,rigid,7605,10100,11828,2495,1728,4223,completed
1353,rigid,7605,10100,11828,2495,1728,4223,completed
1354,rigid,7605,10100,11828,2495,1728,4223,completed
1355,rigid,7605,10100,11828,2495,1728,4223,completed
1356,rigid,7605,10100,11828,2495,1728,4223,completed
1357,rigid,7605,10178,11906,2573,1728,4301,completed
1358,rigid,7605,10180,11908,2575,1728,4303,completed
1359,rigid,7605,10195,11923,2590,1728,4318,completed
1360,rigid,7606,10199,10693,2593,494,3087,completed
1361,rigid,7606,10230,11958,2624,1728,4352,completed
1362,rigid,7606,10231,11959,2625,1728,4353,completed
1363,rigid,7608,10233,10244,2625,11,2636,completed
1364,rigid,7608,10242,10253,2634,11,2645,completed
1365,rigid,7608,10243,10250,2635,7,2642,completed
1366,rigid,7608,10252,11116,2644,864,3508,completed
1367,rigid,7609,10253,10254,2644,1,2645,completed
1368,rigid,7611,10267,11122,2656,855,3511,completed
1369,rigid,7612,10267,10268,2655,1,2656,completed
1370,rigid,7612,10267,10268,2655,1,2656,completed
1371,rigid,7612,10267,10269,2655,2,2657,completed
1372,rigid,7613,10280,11144,2667,864,3531,completed
1373,rigid,7615,10292,10294,2677,2,2679,completed
1374,rigid,7615,10292,10294,2677,2,2679,completed
1375,rigid,7619,10294,10340,2675,46,2721,completed
1376,rigid,7620,10294,10330,2674,36,2710,completed
1377,rigid,7620,10330,10332,2710,2,2712,completed
1378,rigid,7621,10332,10563,2711,231,2942,completed
1379,rigid,7621,10332,12818,2711,2486,5197,completed
1380,rigid,7621,10332,10334,2711,2,2713,completed
1381,rigid,7621,10332,10333,2711,1,2712,completed
1382,rigid,7621,10332,10333,2711,1,2712,completed
1383,rigid,7621,10332,10333,2711,1,2712,completed
1384,rigid,7623,10334,10341,2711,7,2718,completed
1385,rigid,7626,10341,13341,2715,3000,5715,completed
1386,rigid,7627,10349,10350,2722,1,2723,completed
1387,rigid,7629,10349,10350,2720,1,2721,completed
1388,rigid,7629,10349,10350,2720,1,2721,completed
1389,rigid,7631,10349,10351,2718,2,2720,completed
1390,rigid,7634,10349,10366,2715,17,2732,completed
1391,rigid,7635,10350,10352,2715,2,2717,completed
1392,rigid,7635,10350,10352,2715,2,2717,completed
1393,rigid,7637,10350,10352,2713,2,2715,completed
1394,rigid,7637,10350,10352,2713,2,2715,completed
1395,rigid,7637,10350,10353,2713,3,2716,completed
1396,rigid,7637,10351,10355,2714,4,2718,completed
1397,rigid,7640,10352,12825,2712,2473,5185,completed
1398,rigid,7651,10352,10354,2701,2,2703,completed
1399,rigid,7651,10352,10354,2701,2,2703,completed
1400,rigid,7659,10352,10358,2693,6,2699,completed
1401,rigid,7664,10352,10784,2688,432,3120,completed
1402,rigid,7666,10357,10944,2691,587,3278,completed
1403,rigid,7670,10358,10411,2688,53,2741,completed
1404,rigid,7670,10366,10396,2696,30,2726,completed
1405,rigid,7670,10366,10391,2696,25,2721,completed
1406,rigid,7670,10391,10400,2721,9,2730,completed
1407,rigid,7670,10396,10397,2726,1,2727,completed
1408,rigid,7670,10397,10398,2727,1,2728,completed
1409,rigid,7671,10397,10399,2726,2,2728,completed
1410,rigid,7671,10397,10399,2726,2,2728,completed
1411,rigid,7673,10398,11943,2725,1545,4270,completed
1412,rigid,7673,10400,10549,2727,149,2876,completed
1413,rigid,7673,10411,10503,2738,92,2830,completed
1414,rigid,7674,10425,12153,2751,1728,4479,completed
1415,rigid,7674,10448,11657,2774,1209,3983,completed
1416,rigid,7674,10503,11443,2829,940,3769,completed
1417,rigid,7674,10539,11156,2865,617,3482,completed
1418,rigid,7674,10539,11568,2865,1029,3894,completed
1419,rigid,7674,10539,10675,2865,136,3001,completed
1420,rigid,7675,10539,10574,2864,35,2899,completed
1421,rigid,7676,10539,10542,2863,3,2866,completed
1422,rigid,7676,10539,10542,2863,3,2866,completed
1423,rigid,7676,10539,10543,2863,4,2867,completed
1424,rigid,7676,10539,10543,2863,4,2867,completed
1425,rigid,7678,10539,13549,2861,3010,5871,completed
1426,rigid,7679,10689,12203,3010,1514,4524,completed
1427,rigid,7690,10693,11920,3003,1227,4230,completed
1428,rigid,7690,10784,11280,3094,496,3590,completed
1429,rigid,7690,10832,11514,3142,682,3824,completed
1430,rigid,7704,10871,10872,3167,1,3168,completed
1431,rigid,7706,10872,10873,3166,1,3167,completed
1432,rigid,7706,10873,10874,3167,1,3168,completed
1433,rigid,7709,10874,10881,3165,7,3172,completed
1434,rigid,7716,10874,10876,3158,2,3160,completed
1435,rigid,7716,10874,10876,3158,2,3160,completed
1436,rigid,7716,10874,10918,3158,44,3202,completed
1437,rigid,7716,10874,10875,3158,1,3159,completed
1438,rigid,7716,10874,10879,3158,5,3163,completed
1439,rigid,7716,10874,10877,3158,3,3161,completed
1440,rigid,7716,10874,10876,3158,2,3160,completed
1441,rigid,7716,10874,10879,3158,5,3163,completed
1442,rigid,7716,10874,10877,3158,3,3161,completed
1443,rigid,7716,10874,10877,3158,3,3161,completed
1444,rigid,7716,10874,10876,3158,2,3160,completed
1445,rigid,7716,10874,10876,3158,2,3160,completed
1446,rigid,7716,10874,10877,3158,3,3161,completed
1447,rigid,7716,10874,10918,3158,44,3202,completed
1448,rigid,7716,10874,10918,3158,44,3202,completed
1449,rigid,7716,10874,10875,3158,1,3159,completed
1450,rigid,7716,10874,10876,3158,2,3160,completed
1451,rigid,7716,10874,10875,3158,1,3159,completed
1452,rigid,7716,10874,10878,3158,4,3162,completed
1453,rigid,7716,10874,10880,3158,6,3164,completed
1454,rigid,7716,10874,10875,3158,1,3159,completed
1455,rigid,7716,10874,10875,3158,1,3159,completed
1456,rigid,7716,10874,10876,3158,2,3160,completed
1457,rigid,7716,10874,10877,3158,3,3161,completed
1458,rigid,7716,10874,10877,3158,3,3161,completed
1459,rigid,7716,10874,10918,3158,44,3202,completed
1460,rigid,7716,10874,10880,3158,6,3164,completed
1461,rigid,7716,10874,10876,3158,2,3160,completed
1462,rigid,7716,10874,10877,3158,3,3161,completed
1463,rigid,7716,10874,10875,3158,1,3159,completed
1464,rigid,7716,10874,10882,3158,8,3166,completed
1465,rigid,7716,10874,10881,3158,7,3165,completed
1466,rigid,7716,10874,10882,3158,8,3166,completed
1467,rigid,7716,10874,10883,3158,9,3167,completed
1468,rigid,7716,10874,10883,3158,9,3167,completed
1469,rigid,7716,10874,10881,3158,7,3165,completed
1470,rigid,7716,10874,10918,3158,44,3202,completed
1471,rigid,7716,10874,10883,3158,9,3167,completed
1472,rigid,7716,10874,10883,3158,9,3167,completed
1473,rigid,7716,10874,10883,3158,9,3167,completed
1474,rigid,7716,10874,10883,3158,9,3167,completed
1475,rigid,7716,10874,10882,3158,8,3166,completed
1476,rigid,7716,10874,10882,3158,8,3166,completed
1477,rigid,7716,10874,10883,3158,9,3167,completed
1478,rigid,7716,10874,10882,3158,8,3166,completed
1479,rigid,7716,10874,10882,3158,8,3166,completed
1480,rigid,7716,10874,10882,3158,8,3166,completed
1481,rigid,7716,10874,10918,3158,44,3202,completed
1482,rigid,7716,10874,10882,3158,8,3166,completed
1483,rigid,7716,10874,10882,3158,8,3166,completed
1484,rigid,7716,10874,10883,3158,9,3167,completed
1485,rigid,7716,10875,10883,3159,8,3167,completed
1486,rigid,7716,10875,10883,3159,8,3167,completed
1487,rigid,7716,10875,10884,3159,9,3168,completed
1488,rigid,7716,10875,10884,3159,9,3168,completed
1489,rigid,7716,10875,10883,3159,8,3167,completed
1490,rigid,7716,10875,10883,3159,8,3167,completed
1491,rigid,7716,10876,10884,3160,8,3168,completed
1492,rigid,7716,10876,10920,3160,44,3204,completed
1493,rigid,7716,10876,10884,3160,8,3168,completed
1494,rigid,7716,10876,10884,3160,8,3168,completed
1495,rigid,7716,10876,10884,3160,8,3168,completed
1496,rigid,7716,10876,10884,3160,8,3168,completed
1497,rigid,7716,10876,10884,3160,8,3168,completed
1498,rigid,7716,10876,10884,3160,8,3168,completed
1499,rigid,7716,10877,10885,3161,8,3169,completed
1500,rigid,7716,10877,10885,3161,8,3169,completed
1501,rigid,7716,10877,10885,3161,8,3169,completed
1502,rigid,7716,10877,10883,3161,6,3167,completed
1503,rigid,7716,10877,10921,3161,44,3205,completed
1504,rigid,7716,10877,10885,3161,8,3169,completed
1505,rigid,7716,10877,10885,3161,8,3169,completed
1506,rigid,7716,10878,10886,3162,8,3170,completed
1507,rigid,7716,10879,10888,3163,9,3172,completed
1508,rigid,7716,10879,10887,3163,8,3171,completed
1509,rigid,7716,10880,10888,3164,8,3172,completed
1510,rigid,7716,10880,10888,3164,8,3172,completed
1511,rigid,7716,10881,10889,3165,8,3173,completed
1512,rigid,7716,10881,10889,3165,8,3173,completed
1513,rigid,7716,10881,10889,3165,8,3173,completed
1514,rigid,7716,10881,10925,3165,44,3209,completed
1515,rigid,7716,10881,10889,3165,8,3173,completed
1516,rigid,7716,10881,10889,3165,8,3173,completed
1517,rigid,7716,10881,10889,3165,8,3173,completed
1518,rigid,7716,10881,10889,3165,8,3173,completed
1519,rigid,7716,10881,10882,3165,1,3166,completed
1520,rigid,7716,10881,10883,3165,2,3167,completed
1521,rigid,7716,10881,10883,3165,2,3167,completed
1522,rigid,7716,10881,10882,3165,1,3166,completed
1523,rigid,7716,10881,10883,3165,2,3167,completed
1524,rigid,7716,10881,10882,3165,1,3166,completed
1525,rigid,7716,10881,10925,3165,44,3209,completed
1526,rigid,7716,10881,10883,3165,2,3167,completed
1527,rigid,7716,10881,10883,3165,2,3167,completed
1528,rigid,7716,10881,10883,3165,2,3167,completed
1529,rigid,7716,10881,10882,3165,1,3166,completed
1530,rigid,7716,10881,10882,3165,1,3166,completed
1531,rigid,7716,10881,10882,3165,1,3166,completed
1532,rigid,7716,10881,10883,3165,2,3167,completed
1533,rigid,7716,10881,10882,3165,1,3166,completed
1534,rigid,7716,10881,10882,3165,1,3166,completed
1535,rigid,7716,10881,10882,3165,1,3166,completed
1536,rigid,7716,10881,10925,3165,44,3209,completed
1537,rigid,7716,10881,10882,3165,1,3166,completed
1538,rigid,7716,10881,10882,3165,1,3166,completed
1539,rigid,7716,10881,10882,3165,1,3166,completed
1540,rigid,7716,10881,10883,3165,2,3167,completed
1541,rigid,7716,10881,10883,3165,2,3167,completed
1542,rigid,7716,10881,10882,3165,1,3166,completed
1543,rigid,7716,10881,10882,3165,1,3166,completed
1544,rigid,7716,10881,10882,3165,1,3166,completed
1545,rigid,7716,10881,10883,3165,2,3167,completed
1546,rigid,7716,10881,10925,3165,44,3209,completed
1547,rigid,7716,10881,10925,3165,44,3209,completed
1548,rigid,7716,10881,10925,3165,44,3209,completed
1549,rigid,7716,10882,10926,3166,44,3210,completed
1550,rigid,7716,10882,10926,3166,44,3210,completed
1551,rigid,7716,10882,10926,3166,44,3210,completed
1552,rigid,7716,10882,10926,3166,44,3210,completed
1553,rigid,7716,10882,10884,3166,2,3168,completed
1554,rigid,7716,10882,10884,3166,2,3168,completed
1555,rigid,7716,10882,10884,3166,2,3168,completed
1556,rigid,7716,10882,10884,3166,2,3168,completed
1557,rigid,7716,10882,10884,3166,2,3168,completed
1558,rigid,7716,10882,10884,3166,2,3168,completed
1559,rigid,7716,10882,10926,3166,44,3210,completed
1560,rigid,7716,10882,10884,3166,2,3168,completed
1561,rigid,7716,10882,10884,3166,2,3168,completed
1562,rigid,7716,10882,10884,3166,2,3168,completed
1563,rigid,7716,10882,10884,3166,2,3168,completed
1564,rigid,7716,10882,10884,3166,2,3168,completed
1565,rigid,7716,10882,10884,3166,2,3168,completed
1566,rigid,7716,10882,10884,3166,2,3168,completed
1567,rigid,7716,10882,10884,3166,2,3168,completed
1568,rigid,7716,10882,10884,3166,2,3168,completed
1569,rigid,7716,10882,10884,3166,2,3168,completed
1570,rigid,7716,10882,10926,3166,44,3210,completed
1571,rigid,7716,10882,10884,3166,2,3168,completed
1572,rigid,7716,10882,10884,3166,2,3168,completed
1573,rigid,7716,10883,10885,3167,2,3169,completed
1574,rigid,7716,10883,10885,3167,2,3169,completed
1575,rigid,7716,10883,10885,3167,2,3169,completed
1576,rigid,7716,10883,10885,3167,2,3169,completed
1577,rigid,7716,10883,10885,3167,2,3169,completed
1578,rigid,7716,10883,10885,3167,2,3169,completed
1579,rigid,7716,10883,10885,3167,2,3169,completed
1580,rigid,7716,10883,10886,3167,3,3170,completed
1581,rigid,7716,10883,10927,3167,44,3211,completed
1582,rigid,7716,10883,10886,3167,3,3170,completed
1583,rigid,7716,10883,10886,3167,3,3170,completed
1584,rigid,7716,10883,10885,3167,2,3169,completed
1585,rigid,7716,10883,10886,3167,3,3170,completed
1586,rigid,7716,10883,10886,3167,3,3170,completed
1587,rigid,7716,10883,10886,3167,3,3170,completed
1588,rigid,7716,10883,10886,3167,3,3170,completed
1589,rigid,7716,10883,10885,3167,2,3169,completed
1590,rigid,7716,10883,10886,3167,3,3170,completed
1591,rigid,7716,10883,10886,3167,3,3170,completed
1592,rigid,7716,10883,10927,3167,44,3211,completed
1593,rigid,7716,10883,10886,3167,3,3170,completed
1594,rigid,7716,10883,10886,3167,3,3170,completed
1595,rigid,7716,10883,10886,3167,3,3170,completed
1596,rigid,7716,10884,10887,3168,3,3171,completed
1597,rigid,7716,10884,10887,3168,3,3171,completed
1598,rigid,7716,10884,10887,3168,3,3171,completed
1599,rigid,7716,10884,10887,3168,3,3171,completed
1600,rigid,7716,10884,10887,3168,3,3171,completed
1601,rigid,7716,10884,10887,3168,3,3171,completed
1602,rigid,7716,10884,10887,3168,3,3171,completed
1603,rigid,7716,10884,10928,3168,44,3212,completed
1604,rigid,7716,10884,10886,3168,2,3170,completed
1605,rigid,7716,10884,10887,3168,3,3171,completed
1606,rigid,7716,10884,10887,3168,3,3171,completed
1607,rigid,7716,10884,10886,3168,2,3170,completed
1608,rigid,7716,10884,10886,3168,2,3170,completed
1609,rigid,7716,10884,10886,3168,2,3170,completed
1610,rigid,7716,10884,10886,3168,2,3170,completed
1611,rigid,7716,10884,10886,3168,2,3170,completed
1612,rigid,7716,10884,10886,3168,2,3170,completed
1613,rigid,7716,10884,10886,3168,2,3170,completed
1614,rigid,7716,10884,10928,3168,44,3212,completed
1615,rigid,7716,10884,10886,3168,2,3170,completed
1616,rigid,7716,10884,10886,3168,2,3170,completed
1617,rigid,7716,10884,10886,3168,2,3170,completed
1618,rigid,7716,10884,10886,3168,2,3170,completed
1619,rigid,7716,10884,10886,3168,2,3170,completed
1620,rigid,7716,10884,10886,3168,2,3170,completed
1621,rigid,7716,10884,10886,3168,2,3170,completed
1622,rigid,7716,10884,10886,3168,2,3170,completed
1623,rigid,7716,10885,10887,3169,2,3171,completed
1624,rigid,7716,10885,10887,3169,2,3171,completed
1625,rigid,7716,10885,10929,3169,44,3213,completed
1626,rigid,7716,10885,10887,3169,2,3171,completed
1627,rigid,7716,10885,10887,3169,2,3171,completed
1628,rigid,7716,10885,10887,3169,2,3171,completed
1629,rigid,7716,10885,10887,3169,2,3171,completed
1630,rigid,7716,10885,10887,3169,2,3171,completed
1631,rigid,7716,10885,10887,3169,2,3171,completed
1632,rigid,7716,10885,10887,3169,2,3171,completed
1633,rigid,7716,10885,10887,3169,2,3171,completed
1634,rigid,7722,10938,11631,3216,693,3909,completed
1635,rigid,7722,10938,11629,3216,691,3907,completed
1636,rigid,7725,10938,10939,3213,1,3214,completed
1637,rigid,7726,10938,11424,3212,486,3698,completed
1638,rigid,7726,10938,11577,3212,639,3851,completed
1639,rigid,7726,10938,12016,3212,1078,4290,completed
1640,rigid,7733,10938,10968,3205,30,3235,completed
1641,rigid,7734,10938,11586,3204,648,3852,completed
1642,rigid,7735,11109,12602,3374,1493,4867,completed
1643,rigid,7741,11117,11767,3376,650,4026,completed
1644,rigid,7745,11121,11784,3376,663,4039,completed
1645,rigid,7745,11122,12850,3377,1728,5105,completed
1646,rigid,7745,11122,11565,3377,443,3820,completed
1647,rigid,7747,11144,11836,3397,692,4089,completed
1648,rigid,7752,11208,11209,3456,1,3457,completed
1649,rigid,7752,11209,11210,3457,1,3458,completed
1650,rigid,7754,11209,11242,3455,33,3488,completed
1651,rigid,7762,11210,11235,3448,25,3473,completed
1652,rigid,7763,11210,11859,3447,649,4096,completed
1653,rigid,7766,11210,11212,3444,2,3446,completed
1654,rigid,7766,11210,11212,3444,2,3446,completed
1655,rigid,7766,11210,11287,3444,77,3521,completed
1656,rigid,7766,11210,11212,3444,2,3446,completed
1657,rigid,7766,11210,11215,3444,5,3449,completed
1658,rigid,7766,11210,11214,3444,4,3448,completed
1659,rigid,7766,11210,11212,3444,2,3446,completed
1660,rigid,7766,11210,11215,3444,5,3449,completed
1661,rigid,7766,11210,11213,3444,3,3447,completed
1662,rigid,7766,11210,11214,3444,4,3448,completed
1663,rigid,7766,11210,11212,3444,2,3446,completed
1664,rigid,7766,11210,11212,3444,2,3446,completed
1665,rigid,7766,11210,11214,3444,4,3448,completed
1666,rigid,7766,11210,11281,3444,71,3515,completed
1667,rigid,7766,11210,11287,3444,77,3521,completed
1668,rigid,7766,11210,11212,3444,2,3446,completed
1669,rigid,7766,11210,11212,3444,2,3446,completed
1670,rigid,7766,11210,11212,3444,2,3446,completed
1671,rigid,7766,11210,11215,3444,5,3449,completed
1672,rigid,7766,11210,11216,3444,6,3450,completed
1673,rigid,7766,11210,11212,3444,2,3446,completed
1674,rigid,7766,11210,11212,3444,2,3446,completed
1675,rigid,7766,11210,11212,3444,2,3446,completed
1676,rigid,7766,11210,11214,3444,4,3448,completed
1677,rigid,7766,11210,11213,3444,3,3447,completed
1678,rigid,7766,11210,11282,3444,72,3516,completed
1679,rigid,7766,11210,11217,3444,7,3451,completed
1680,rigid,7766,11210,11212,3444,2,3446,completed
1681,rigid,7766,11210,11214,3444,4,3448,completed
1682,rigid,7766,11210,11212,3444,2,3446,completed
1683,rigid,7766,11210,11219,3444,9,3453,completed
1684,rigid,7766,11210,11218,3444,8,3452,completed
1685,rigid,7766,11210,11219,3444,9,3453,completed
1686,rigid,7766,11210,11218,3444,8,3452,completed
1687,rigid,7766,11210,11219,3444,9,3453,completed
1688,rigid,7766,11210,11218,3444,8,3452,completed
1689,rigid,7766,11210,11284,3444,74,3518,completed
1690,rigid,7766,11210,11219,3444,9,3453,completed
1691,rigid,7766,11210,11219,3444,9,3453,completed
1692,rigid,7766,11210,11219,3444,9,3453,completed
1693,rigid,7766,11210,11219,3444,9,3453,completed
1694,rigid,7766,11210,11219,3444,9,3453,completed
1695,rigid,7766,11210,11219,3444,9,3453,completed
1696,rigid,7766,11210,11219,3444,9,3453,completed
1697,rigid,7766,11210,11219,3444,9,3453,completed
1698,rigid,7766,11210,11219,3444,9,3453,completed
1699,rigid,7766,11210,11219,3444,9,3453,completed
1700,rigid,7766,11210,11284,3444,74,3518,completed
1701,rigid,7766,11210,11219,3444,9,3453,completed
1702,rigid,7766,11210,11219,3444,9,3453,completed
1703,rigid,7766,11210,11219,3444,9,3453,completed
1704,rigid,7766,11210,11219,3444,9,3453,completed
1705,rigid,7766,11210,11218,3444,8,3452,completed
1706,rigid,7766,11210,11219,3444,9,3453,completed
1707,rigid,7766,11210,11219,3444,9,3453,completed
1708,rigid,7766,11210,11219,3444,9,3453,completed
1709,rigid,7766,11210,11219,3444,9,3453,completed
1710,rigid,7766,11210,11219,3444,9,3453,completed
1711,rigid,7766,11210,11282,3444,72,3516,completed
1712,rigid,7766,11210,11219,3444,9,3453,completed
1713,rigid,7766,11210,11219,3444,9,3453,completed
1714,rigid,7766,11210,11219,3444,9,3453,completed
1715,rigid,7766,11210,11219,3444,9,3453,completed
1716,rigid,7766,11210,11219,3444,9,3453,completed
1717,rigid,7766,11210,11219,3444,9,3453,completed
1718,rigid,7766,11210,11219,3444,9,3453,completed
1719,rigid,7766,11210,11219,3444,9,3453,completed
1720,rigid,7766,11210,11219,3444,9,3453,completed
1721,rigid,7766,11210,11217,3444,7,3451,completed
1722,rigid,7766,11210,11285,3444,75,3519,completed
1723,rigid,7766,11210,11219,3444,9,3453,completed
1724,rigid,7766,11210,11219,3444,9,3453,completed
1725,rigid,7766,11210,11219,3444,9,3453,completed
1726,rigid,7766,11212,11221,3446,9,3455,completed
1727,rigid,7766,11212,11221,3446,9,3455,completed
1728,rigid,7766,11212,11220,3446,8,3454,completed
1729,rigid,7766,11212,11221,3446,9,3455,completed
1730,rigid,7766,11212,11221,3446,9,3455,completed
1731,rigid,7766,11212,11221,3446,9,3455,completed
1732,rigid,7766,11212,11221,3446,9,3455,completed
1733,rigid,7766,11212,11282,3446,70,3516,completed
1734,rigid,7766,11212,11221,3446,9,3455,completed
1735,rigid,7766,11212,11221,3446,9,3455,completed
1736,rigid,7766,11212,11221,3446,9,3455,completed
1737,rigid,7766,11212,11221,3446,9,3455,completed
1738,rigid,7766,11212,11214,3446,2,3448,completed
1739,rigid,7766,11212,11214,3446,2,3448,completed
1740,rigid,7766,11213,11215,3447,2,3449,completed
1741,rigid,7766,11213,11215,3447,2,3449,completed
1742,rigid,7766,11214,11216,3448,2,3450,completed
1743,rigid,7766,11214,11216,3448,2,3450,completed
1744,rigid,7766,11214,11284,3448,70,3518,completed
1745,rigid,7766,11214,11216,3448,2,3450,completed
1746,rigid,7766,11214,11216,3448,2,3450,completed
1747,rigid,7766,11214,11216,3448,2,3450,completed
1748,rigid,7766,11214,11216,3448,2,3450,completed
1749,rigid,7766,11215,11217,3449,2,3451,completed
1750,rigid,7766,11215,11217,3449,2,3451,completed
1751,rigid,7766,11215,11217,3449,2,3451,completed
1752,rigid,7766,11215,11217,3449,2,3451,completed
1753,rigid,7766,11215,11217,3449,2,3451,completed
1754,rigid,7766,11216,11218,3450,2,3452,completed
1755,rigid,7766,11216,11291,3450,75,3525,completed
1756,rigid,7766,11216,11218,3450,2,3452,completed
1757,rigid,7766,11216,11218,3450,2,3452,completed
1758,rigid,7766,11216,11218,3450,2,3452,completed
1759,rigid,7766,11216,11218,3450,2,3452,completed
1760,rigid,7766,11216,11218,3450,2,3452,completed
1761,rigid,7766,11217,11218,3451,1,3452,completed
1762,rigid,7766,11217,11218,3451,1,3452,completed
1763,rigid,7766,11217,11218,3451,1,3452,completed
1764,rigid,7766,11217,11218,3451,1,3452,completed
1765,rigid,7766,11217,11291,3451,74,3525,completed
1766,rigid,7766,11217,11287,3451,70,3521,completed
1767,rigid,7766,11217,11290,3451,73,3524,completed
1768,rigid,7766,11218,11288,3452,70,3522,completed
1769,rigid,7766,11218,11293,3452,75,3527,completed
1770,rigid,7766,11218,11288,3452,70,3522,completed
1771,rigid,7766,11218,11292,3452,74,3526,completed
1772,rigid,7766,11218,11220,3452,2,3454,completed
1773,rigid,7766,11218,11220,3452,2,3454,completed
1774,rigid,7766,11218,11220,3452,2,3454,completed
1775,rigid,7766,11218,11220,3452,2,3454,completed
1776,rigid,7766,11218,11220,3452,2,3454,completed
1777,rigid,7766,11218,11220,3452,2,3454,completed
1778,rigid,7766,11218,11295,3452,77,3529,completed
1779,rigid,7766,11218,11220,3452,2,3454,completed
1780,rigid,7766,11218,11220,3452,2,3454,completed
1781,rigid,7766,11218,11220,3452,2,3454,completed
1782,rigid,7766,11219,11221,3453,2,3455,completed
1783,rigid,7766,11219,11221,3453,2,3455,completed
1784,rigid,7766,11219,11221,3453,2,3455,completed
1785,rigid,7766,11219,11221,3453,2,3455,completed
1786,rigid,7766,11219,11221,3453,2,3455,completed
1787,rigid,7766,11219,11221,3453,2,3455,completed
1788,rigid,7766,11219,11221,3453,2,3455,completed
1789,rigid,7766,11219,11296,3453,77,3530,completed
1790,rigid,7766,11219,11221,3453,2,3455,completed
1791,rigid,7766,11219,11221,3453,2,3455,completed
1792,rigid,7766,11219,11221,3453,2,3455,completed
1793,rigid,7766,11219,11221,3453,2,3455,completed
1794,rigid,7766,11219,11221,3453,2,3455,completed
1795,rigid,7766,11219,11221,3453,2,3455,completed
1796,rigid,7766,11219,11221,3453,2,3455,completed
1797,rigid,7766,11219,11221,3453,2,3455,completed
1798,rigid,7766,11219,11221,3453,2,3455,completed
1799,rigid,7766,11219,11222,3453,3,3456,completed
1800,rigid,7766,11219,11291,3453,72,3525,completed
1801,rigid,7766,11219,11222,3453,3,3456,completed
1802,rigid,7766,11219,11221,3453,2,3455,completed
1803,rigid,7766,11219,11221,3453,2,3455,completed
1804,rigid,7766,11219,11221,3453,2,3455,completed
1805,rigid,7766,11219,11222,3453,3,3456,completed
1806,rigid,7766,11219,11222,3453,3,3456,completed
1807,rigid,7766,11219,11222,3453,3,3456,completed
1808,rigid,7766,11219,11221,3453,2,3455,completed
1809,rigid,7766,11219,11222,3453,3,3456,completed
1810,rigid,7766,11219,11222,3453,3,3456,completed
1811,rigid,7766,11219,11292,3453,73,3526,completed
1812,rigid,7766,11219,11222,3453,3,3456,completed
1813,rigid,7766,11219,11222,3453,3,3456,completed
1814,rigid,7766,11219,11222,3453,3,3456,completed
1815,rigid,7766,11219,11222,3453,3,3456,completed
1816,rigid,7766,11220,11223,3454,3,3457,completed
1817,rigid,7766,11220,11223,3454,3,3457,completed
1818,rigid,7766,11220,11222,3454,2,3456,completed
1819,rigid,7766,11220,11222,3454,2,3456,completed
1820,rigid,7766,11220,11223,3454,3,3457,completed
1821,rigid,7766,11220,11222,3454,2,3456,completed
1822,rigid,7766,11220,11283,3454,63,3517,completed
1823,rigid,7766,11220,11222,3454,2,3456,completed
1824,rigid,7766,11220,11222,3454,2,3456,completed
1825,rigid,7766,11220,11222,3454,2,3456,completed
1826,rigid,7766,11221,11223,3455,2,3457,completed
1827,rigid,7766,11221,11223,3455,2,3457,completed
1828,rigid,7766,11221,11223,3455,2,3457,completed
1829,rigid,7766,11221,11223,3455,2,3457,completed
1830,rigid,7766,11221,11223,3455,2,3457,completed
1831,rigid,7766,11221,11223,3455,2,3457,completed
1832,rigid,7766,11221,11223,3455,2,3457,completed
1833,rigid,7766,11221,11294,3455,73,3528,completed
1834,rigid,7766,11221,11223,3455,2,3457,completed
1835,rigid,7766,11221,11223,3455,2,3457,completed
1836,rigid,7766,11221,11223,3455,2,3457,completed
1837,rigid,7766,11221,11223,3455,2,3457,completed
1838,rigid,7766,11221,11223,3455,2,3457,completed
1839,rigid,7766,11221,11223,3455,2,3457,completed
1840,rigid,7766,11221,11223,3455,2,3457,completed
1841,rigid,7766,11221,11223,3455,2,3457,completed
1842,rigid,7766,11221,11223,3455,2,3457,completed
1843,rigid,7766,11221,11223,3455,2,3457,completed
1844,rigid,7766,11221,11289,3455,68,3523,completed
1845,rigid,7766,11221,11223,3455,2,3457,completed
1846,rigid,7766,11221,11223,3455,2,3457,completed
1847,rigid,7766,11221,11223,3455,2,3457,completed
1848,rigid,7766,11221,11223,3455,2,3457,completed
1849,rigid,7766,11221,11223,3455,2,3457,completed
1850,rigid,7766,11221,11223,3455,2,3457,completed
1851,rigid,7766,11221,11223,3455,2,3457,completed
1852,rigid,7766,11221,11223,3455,2,3457,completed
1853,rigid,7768,11223,12951,3455,1728,5183,completed
1854,rigid,7768,11228,12956,3460,1728,5188,completed
1855,rigid,7768,11235,12963,3467,1728,5195,completed
1856,rigid,7771,11242,11879,3471,637,4108,completed
1857,rigid,7771,11280,11899,3509,619,4128,completed
1858,rigid,7771,11286,12468,3515,1182,4697,completed
1859,rigid,7779,11286,11428,3507,142,3649,completed
1860,rigid,7779,11286,11426,3507,140,3647,completed
1861,rigid,7779,11286,11425,3507,139,3646,completed
1862,rigid,7779,11295,11434,3516,139,3655,completed
1863,rigid,7779,11423,11564,3644,141,3785,completed
1864,rigid,7779,11424,11565,3645,141,3786,completed
1865,rigid,7779,11425,11454,3646,29,3675,completed
1866,rigid,7779,11426,11453,3647,27,3674,completed
1867,rigid,7779,11428,11569,3649,141,3790,completed
1868,rigid,7779,11434,11573,3655,139,3794,completed
1869,rigid,7779,11435,11574,3656,139,3795,completed
1870,rigid,7779,11439,11577,3660,138,3798,completed
1871,rigid,7779,11443,11582,3664,139,3803,completed
1872,rigid,7779,11444,11583,3665,139,3804,completed
1873,rigid,7779,11453,11592,3674,139,3813,completed
1874,rigid,7779,11454,11595,3675,141,3816,completed
1875,rigid,7807,11506,11507,3699,1,3700,completed
1876,rigid,7808,11507,11508,3699,1,3700,completed
1877,rigid,7808,11507,15107,3699,3600,7299,completed
1878,rigid,7812,11508,11509,3696,1,3697,completed
1879,rigid,7812,11508,11673,3696,165,3861,completed
1880,rigid,7812,11508,11539,3696,31,3727,completed
1881,rigid,7812,11508,12178,3696,670,4366,completed
1882,rigid,7812,11508,11954,3696,446,4142,completed
1883,rigid,7812,11508,11625,3696,117,3813,completed
1884,rigid,7812,11509,11555,3697,46,3743,completed
1885,rigid,7812,11509,11936,3697,427,4124,completed
1886,rigid,7812,11509,11561,3697,52,3749,completed
1887,rigid,7812,11509,12022,3697,513,4210,completed
1888,rigid,7812,11509,11798,3697,289,3986,completed
1889,rigid,7812,11514,11522,3702,8,3710,completed
1890,rigid,7812,11522,12043,3710,521,4231,completed
1891,rigid,7812,11528,11624,3716,96,3812,completed
1892,rigid,7812,11539,11632,3727,93,3820,completed
1893,rigid,7812,11555,11786,3743,231,3974,completed
1894,rigid,7812,11561,11817,3749,256,4005,completed
1895,rigid,7812,11564,11767,3752,203,3955,completed
1896,rigid,7812,11565,11606,3753,41,3794,completed
1897,rigid,7812,11565,11619,3753,54,3807,completed
1898,rigid,7812,11567,11862,3755,295,4050,completed
1899,rigid,7820,11583,11604,3763,21,3784,completed
1900,rigid,7831,11586,28819,3755,17233,20988,completed
1901,rigid,7857,11587,13884,3730,2297,6027,completed
1902,rigid,7859,11604,39001,3745,27397,31142,completed
1903,rigid,7862,11604,14827,3742,3223,6965,completed
1904,rigid,7878,11604,12448,3726,844,4570,completed
1905,rigid,7893,11604,11618,3711,14,3725,completed
1906,rigid,7896,11604,12665,3708,1061,4769,completed
1907,rigid,7903,11615,11823,3712,208,3920,completed
1908,rigid,7903,11618,11820,3715,202,3917,completed
1909,rigid,8033,11629,12562,3596,933,4529,completed
1910,rigid,8035,11631,12198,3596,567,4163,completed
1911,rigid,8090,11631,12063,3541,432,3973,completed
1912,rigid,8111,11631,12063,3520,432,3952,completed
1913,rigid,8143,11631,13277,3488,1646,5134,completed
1914,rigid,8145,11632,13173,3487,1541,5028,completed
1915,rigid,8190,11632,11633,3442,1,3443,completed
1916,rigid,8201,11675,12242,3474,567,4041,completed
1917,rigid,8224,11675,11693,3451,18,3469,completed
1918,rigid,8224,11675,11693,3451,18,3469,completed
1919,rigid,8309,11685,12270,3376,585,3961,completed
1920,rigid,8346,11685,12502,3339,817,4156,completed
1921,rigid,8356,11707,12869,3351,1162,4513,completed
1922,rigid,8384,11741,12392,3357,651,4008,completed
1923,rigid,8393,11767,12415,3374,648,4022,completed
1924,rigid,8415,11786,12478,3371,692,4063,completed
1925,rigid,8417,11820,12510,3403,690,4093,completed
1926,rigid,8447,11823,12476,3376,653,4029,completed
1927,rigid,8460,11828,12521,3368,693,4061,completed
1928,rigid,8499,11836,12700,3337,864,4201,completed
1929,rigid,8511,11838,11852,3327,14,3341,completed
1930,rigid,8517,11849,12281,3332,432,3764,completed
1931,rigid,8530,11852,11853,3322,1,3323,completed
1932,rigid,8536,11852,13080,3316,1228,4544,completed
1933,rigid,8546,11853,11854,3307,1,3308,completed
1934,rigid,8577,11854,12715,3277,861,4138,completed
1935,rigid,8603,11859,12429,3256,570,3826,completed
1936,rigid,8608,11899,16067,3291,4168,7459,completed
1937,rigid,8615,11906,11980,3291,74,3365,completed
1938,rigid,8618,11908,12014,3290,106,3396,completed
1939,rigid,8622,11920,12055,3298,135,3433,completed
1940,rigid,8623,11923,11927,3300,4,3304,completed
1941,rigid,8624,11954,12810,3330,856,4186,completed
1942,rigid,8626,11958,11959,3332,1,3333,completed
1943,rigid,8700,11959,11960,3259,1,3260,completed
1944,rigid,8746,12022,16052,3276,4030,7306,completed
1945,rigid,8755,12063,12069,3308,6,3314,completed
1946,rigid,8759,12069,12074,3310,5,3315,completed
1947,rigid,8762,12074,12077,3312,3,3315,completed
1948,rigid,8766,12134,15554,3368,3420,6788,completed
1949,rigid,8768,12198,12766,3430,568,3998,completed
1950,rigid,8770,12203,15617,3433,3414,6847,completed
1951,rigid,8779,12203,12256,3424,53,3477,completed
1952,rigid,8780,12203,15761,3423,3558,6981,completed
1953,rigid,8786,12203,15659,3417,3456,6873,completed
1954,rigid,8798,12203,13067,3405,864,4269,completed
1955,rigid,8823,12203,12208,3380,5,3385,completed
1956,rigid,8834,12242,13970,3408,1728,5136,completed
1957,rigid,8858,12242,13970,3384,1728,5112,completed
1958,rigid,8859,12242,13970,3383,1728,5111,completed
1959,rigid,8863,12242,12289,3379,47,3426,completed
1960,rigid,8869,12242,13970,3373,1728,5101,completed
1961,rigid,8894,12270,12853,3376,583,3959,completed
1962,rigid,8898,12270,12406,3372,136,3508,completed
1963,rigid,8898,12270,12379,3372,109,3481,completed
1964,rigid,8898,12270,12344,3372,74,3446,completed
1965,rigid,8907,12270,12274,3363,4,3367,completed
1966,rigid,8910,12274,12275,3364,1,3365,completed
1967,rigid,8932,12344,13205,3412,861,4273,completed
1968,rigid,8959,12392,13226,3433,834,4267,completed
1969,rigid,8968,12406,12408,3438,2,3440,completed
1970,rigid,8968,12415,12418,3447,3,3450,completed
1971,rigid,8968,12418,12421,3450,3,3453,completed
1972,rigid,8986,12418,13242,3432,824,4256,completed
1973,rigid,9036,12421,13070,3385,649,4034,completed
1974,rigid,9042,12429,13080,3387,651,4038,completed
1975,rigid,9101,12476,13127,3375,651,4026,completed
1976,rigid,9107,12478,13174,3371,696,4067,completed
1977,rigid,9107,12502,13199,3395,697,4092,completed
1978,rigid,9153,12510,13202,3357,692,4049,completed
1979,rigid,9248,12515,13586,3267,1071,4338,completed
1980,rigid,9248,12518,13319,3270,801,4071,completed
1981,rigid,9258,12521,13010,3263,489,3752,completed
1982,rigid,9258,12521,13156,3263,635,3898,completed
1983,rigid,9354,12602,12608,3248,6,3254,completed
1984,rigid,9366,12608,13011,3242,403,3645,completed
1985,rigid,9376,12619,13828,3243,1209,4452,completed
1986,rigid,9376,12665,13874,3289,1209,4498,completed
1987,rigid,9376,12699,13908,3323,1209,4532,completed
1988,rigid,9376,12700,13909,3324,1209,4533,completed
1989,rigid,9376,12715,13924,3339,1209,4548,completed
1990,rigid,9383,12766,13267,3383,501,3884,completed
1991,rigid,9383,12766,13272,3383,506,3889,completed
1992,rigid,9383,12798,13307,3415,509,3924,completed
1993,rigid,9383,12798,13304,3415,506,3921,completed
1994,rigid,9383,12810,13319,3427,509,3936,completed
1995,rigid,9383,12853,13364,3470,511,3981,completed
1996,rigid,9383,12853,13371,3470,518,3988,completed
1997,rigid,9383,12869,13382,3486,513,3999,completed
1998,rigid,9383,12887,13401,3504,514,4018,completed
1999,rigid,9383,12887,13408,3504,521,4025,completed
2000,rigid,9383,12889,13404,3506,515,4021,completed
2001,rigid,9409,12895,13503,3486,608,4094,completed
2002,rigid,9409,12951,13727,3542,776,4318,completed
2003,rigid,9413,12956,13030,3543,74,3617,completed
2004,rigid,9413,12963,13069,3550,106,3656,completed
2005,rigid,9413,13010,13146,3597,136,3733,completed
2006,rigid,9439,13011,13866,3572,855,4427,completed
2007,rigid,9480,13011,13865,3531,854,4385,completed
2008,rigid,9571,13011,13017,3440,6,3446,completed
2009,rigid,9572,13011,13706,3439,695,4134,completed
2010,rigid,9572,13011,14055,3439,1044,4483,completed
2011,rigid,9578,13011,13015,3433,4,3437,completed
2012,rigid,9584,13011,13023,3427,12,3439,completed
2013,rigid,9586,13011,13012,3425,1,3426,completed
2014,rigid,9588,13011,13064,3423,53,3476,completed
2015,rigid,9600,13011,13029,3411,18,3429,completed
2016,rigid,9619,13011,13017,3392,6,3398,completed
2017,rigid,9630,13011,13015,3381,4,3385,completed
2018,rigid,9639,13011,13014,3372,3,3375,completed
2019,rigid,9665,13011,13064,3346,53,3399,completed
2020,rigid,9665,13011,13067,3346,56,3402,completed
2021,rigid,9665,13011,13070,3346,59,3405,completed
2022,rigid,9665,13011,13069,3346,58,3404,completed
2023,rigid,9665,13011,13062,3346,51,3397,completed
2024,rigid,9665,13011,13063,3346,52,3398,completed
2025,rigid,9665,13011,13065,3346,54,3400,completed
2026,rigid,9665,13011,13074,3346,63,3409,completed
2027,rigid,9665,13011,13059,3346,48,3394,completed
2028,rigid,9665,13011,13059,3346,48,3394,completed
2029,rigid,9665,13011,13074,3346,63,3409,completed
2030,rigid,9665,13011,13063,3346,52,3398,completed
2031,rigid,9665,13011,13064,3346,53,3399,completed
2032,rigid,9665,13011,13068,3346,57,3403,completed
2033,rigid,9665,13011,13068,3346,57,3403,completed
2034,rigid,9665,13011,13067,3346,56,3402,completed
2035,rigid,9665,13011,13070,3346,59,3405,completed
2036,rigid,9665,13011,13077,3346,66,3412,completed
2037,rigid,9665,13011,13066,3346,55,3401,completed
2038,rigid,9665,13011,13069,3346,58,3404,completed
2039,rigid,9665,13011,13075,3346,64,3410,completed
2040,rigid,9665,13011,13069,3346,58,3404,completed
2041,rigid,9665,13011,13068,3346,57,3403,completed
2042,rigid,9665,13011,13070,3346,59,3405,completed
2043,rigid,9665,13011,13068,3346,57,3403,completed
2044,rigid,9665,13011,13070,3346,59,3405,completed
2045,rigid,9665,13011,13074,3346,63,3409,completed
2046,rigid,9665,13011,13069,3346,58,3404,completed
2047,rigid,9665,13011,13070,3346,59,3405,completed
2048,rigid,9665,13011,13077,3346,66,3412,completed
2049,rigid,9665,13011,13085,3346,74,3420,completed
2050,rigid,9665,13011,13064,3346,53,3399,completed
2051,rigid,9665,13011,13077,3346,66,3412,completed
2052,rigid,9665,13012,13077,3347,65,3412,completed
2053,rigid,9665,13014,13078,3349,64,3413,completed
2054,rigid,9665,13014,13084,3349,70,3419,completed
2055,rigid,9665,13014,13085,3349,71,3420,completed
2056,rigid,9665,13014,13085,3349,71,3420,completed
2057,rigid,9665,13014,13078,3349,64,3413,completed
2058,rigid,9665,13014,13078,3349,64,3413,completed
2059,rigid,9665,13014,13082,3349,68,3417,completed
2060,rigid,9665,13015,13085,3350,70,3420,completed
2061,rigid,9665,13015,13083,3350,68,3418,completed
2062,rigid,9665,13015,13095,3350,80,3430,completed
2063,rigid,9665,13015,13101,3350,86,3436,completed
2064,rigid,9665,13015,13102,3350,87,3437,completed
2065,rigid,9665,13015,13099,3350,84,3434,completed
2066,rigid,9665,13015,13098,3350,83,3433,completed
2067,rigid,9665,13017,13113,3352,96,3448,completed
2068,rigid,9665,13017,13109,3352,92,3444,completed
2069,rigid,9665,13017,13113,3352,96,3448,completed
2070,rigid,9665,13017,13113,3352,96,3448,completed
2071,rigid,9665,13017,13114,3352,97,3449,completed
2072,rigid,9665,13017,13115,3352,98,3450,completed
2073,rigid,9665,13017,13103,3352,86,3438,completed
2074,rigid,9665,13017,13120,3352,103,3455,completed
2075,rigid,9665,13023,13136,3358,113,3471,completed
2076,rigid,9665,13023,13127,3358,104,3462,completed
2077,rigid,9665,13023,13123,3358,100,3458,completed
2078,rigid,9665,13029,13141,3364,112,3476,completed
2079,rigid,9672,13030,13031,3358,1,3359,completed
2080,rigid,9672,13031,13032,3359,1,3360,completed
2081,rigid,9672,13032,13033,3360,1,3361,completed
2082,rigid,9672,13033,13034,3361,1,3362,completed
2083,rigid,9672,13034,13035,3362,1,3363,completed
2084,rigid,9672,13035,13036,3363,1,3364,completed
2085,rigid,9672,13036,13037,3364,1,3365,completed
2086,rigid,9673,13037,13038,3364,1,3365,completed
2087,rigid,9673,13038,13039,3365,1,3366,completed
2088,rigid,9673,13039,13040,3366,1,3367,completed
2089,rigid,9673,13040,13041,3367,1,3368,completed
2090,rigid,9673,13041,13042,3368,1,3369,completed
2091,rigid,9673,13042,13043,3369,1,3370,completed
2092,rigid,9673,13043,13044,3370,1,3371,completed
2093,rigid,9673,13044,13045,3371,1,3372,completed
2094,rigid,9673,13045,13046,3372,1,3373,completed
2095,rigid,9673,13046,13047,3373,1,3374,completed
2096,rigid,9673,13047,13048,3374,1,3375,completed
2097,rigid,9673,13048,13049,3375,1,3376,completed
2098,rigid,9673,13049,13050,3376,1,3377,completed
2099,rigid,9673,13050,13051,3377,1,3378,completed
2100,rigid,9673,13051,13052,3378,1,3379,completed
2101,rigid,9673,13052,13053,3379,1,3380,completed
2102,rigid,9673,13053,13054,3380,1,3381,completed
2103,rigid,9673,13054,13055,3381,1,3382,completed
2104,rigid,9673,13055,13057,3382,2,3384,completed
2105,rigid,9673,13057,13058,3384,1,3385,completed
2106,rigid,9673,13058,13060,3385,2,3387,completed
2107,rigid,9673,13059,13061,3386,2,3388,completed
2108,rigid,9673,13060,13062,3387,2,3389,completed
2109,rigid,9674,13061,13063,3387,2,3389,completed
2110,rigid,9674,13062,13064,3388,2,3390,completed
2111,rigid,9674,13063,13065,3389,2,3391,completed
2112,rigid,9674,13063,13065,3389,2,3391,completed
2113,rigid,9674,13064,13066,3390,2,3392,completed
2114,rigid,9674,13064,13066,3390,2,3392,completed
2115,rigid,9674,13065,13067,3391,2,3393,completed
2116,rigid,9674,13065,13067,3391,2,3393,completed
2117,rigid,9674,13066,13068,3392,2,3394,completed
2118,rigid,9674,13066,13068,3392,2,3394,completed
2119,rigid,9683,13067,14795,3384,1728,5112,completed
2120,rigid,9684,13067,14795,3383,1728,5111,completed
2121,rigid,9686,13070,13720,3384,650,4034,completed
2122,rigid,9693,13070,13719,3377,649,4026,completed
2123,rigid,9696,13127,14611,3431,1484,4915,completed
2124,rigid,9753,13127,13140,3374,13,3387,completed
2125,rigid,9754,13127,13842,3373,715,4088,completed
2126,rigid,9756,13141,13854,3385,713,4098,completed
2127,rigid,9763,13156,14729,3393,1573,4966,completed
2128,rigid,9765,13156,14663,3391,1507,4898,completed
2129,rigid,9767,13157,14885,3390,1728,5118,completed
2130,rigid,9771,13157,13162,3386,5,3391,completed
2131,rigid,9778,13157,13158,3379,1,3380,completed
2132,rigid,9788,13158,13187,3370,29,3399,completed
2133,rigid,9790,13174,14872,3384,1698,5082,completed
2134,rigid,9803,13187,13879,3384,692,4076,completed
2135,rigid,9805,13199,13890,3394,691,4085,completed
2136,rigid,9841,13202,14930,3361,1728,5089,completed
2137,rigid,9843,13205,13853,3362,648,4010,completed
2138,rigid,9843,13226,13701,3383,475,3858,completed
2139,rigid,9846,13242,13936,3396,694,4090,completed
2140,rigid,9872,13256,13734,3384,478,3862,completed
2141,rigid,9872,13256,13870,3384,614,3998,completed
2142,rigid,9884,13267,13769,3383,502,3885,completed
2143,rigid,9889,13272,13777,3383,505,3888,completed
2144,rigid,9890,13283,13789,3393,506,3899,completed
2145,rigid,9892,13304,13811,3412,507,3919,completed
2146,rigid,9893,13307,13811,3414,504,3918,completed
2147,rigid,9894,13319,13826,3425,507,3932,completed
2148,rigid,9899,13319,13898,3420,579,3999,completed
2149,rigid,9899,13341,14107,3442,766,4208,completed
2150,rigid,9901,13364,13878,3463,514,3977,completed
2151,rigid,9902,13371,13879,3469,508,3977,completed
2152,rigid,9921,13382,13895,3461,513,3974,completed
2153,rigid,9960,13401,13919,3441,518,3959,completed
2154,rigid,9992,13404,13919,3412,515,3927,completed
2155,rigid,10037,13408,14210,3371,802,4173,completed
2156,rigid,10118,13408,13665,3290,257,3547,completed
2157,rigid,10118,13408,16864,3290,3456,6746,completed
2158,rigid,10118,13408,16864,3290,3456,6746,completed
2159,rigid,10121,13503,13525,3382,22,3404,completed
2160,rigid,10146,13503,14495,3357,992,4349,completed
2161,rigid,10146,13503,14101,3357,598,3955,completed
2162,rigid,10146,13503,14066,3357,563,3920,completed
2163,rigid,10147,13519,14116,3372,597,3969,completed
2164,rigid,10147,13519,13960,3372,441,3813,completed
2165,rigid,10147,13519,14330,3372,811,4183,completed
2166,rigid,10150,13519,13570,3369,51,3420,completed
2167,rigid,10150,13525,13639,3375,114,3489,completed
2168,rigid,10150,13549,13716,3399,167,3566,completed
2169,rigid,10150,13549,14448,3399,899,4298,completed
2170,rigid,10150,13549,13796,3399,247,3646,completed
2171,rigid,10150,13549,13939,3399,390,3789,completed
2172,rigid,10151,13570,14996,3419,1426,4845,completed
2173,rigid,10151,13586,13850,3435,264,3699,completed
2174,rigid,10151,13586,13707,3435,121,3556,completed
2175,rigid,10152,13586,14599,3434,1013,4447,completed
2176,rigid,10152,13586,14763,3434,1177,4611,completed
2177,rigid,10152,13639,13880,3487,241,3728,completed
2178,rigid,10152,13665,14630,3513,965,4478,completed
2179,rigid,10152,13701,14660,3549,959,4508,completed
2180,rigid,10152,13701,14930,3549,1229,4778,completed
2181,rigid,10152,13701,14571,3549,870,4419,completed
2182,rigid,10152,13701,14188,3549,487,4036,completed
2183,rigid,10152,13706,14507,3554,801,4355,completed
2184,rigid,10153,13706,14344,3553,638,4191,completed
2185,rigid,10153,13706,14739,3553,1033,4586,completed
2186,rigid,10153,13706,14456,3553,750,4303,completed
2187,rigid,10153,13707,14877,3554,1170,4724,completed
2188,rigid,10153,13716,14347,3563,631,4194,completed
2189,rigid,10153,13719,14505,3566,786,4352,completed
2190,rigid,10153,13719,13750,3566,31,3597,completed
2191,rigid,10153,13719,14875,3566,1156,4722,completed
2192,rigid,10153,13719,14227,3566,508,4074,completed
2193,rigid,10153,13719,14138,3566,419,3985,completed
2194,rigid,10154,13719,15447,3565,1728,5293,completed
2195,rigid,10154,13720,14907,3566,1187,4753,completed
2196,rigid,10154,13720,14345,3566,625,4191,completed
2197,rigid,10154,13720,14898,3566,1178,4744,completed
2198,rigid,10154,13720,14996,3566,1276,4842,completed
2199,rigid,10154,13720,15115,3566,1395,4961,completed
2200,rigid,10154,13720,14341,3566,621,4187,completed
2201,rigid,10154,13727,14644,3573,917,4490,completed
2202,rigid,10154,13727,14927,3573,1200,4773,completed
2203,rigid,10154,13727,14233,3573,506,4079,completed
2204,rigid,10154,13727,14679,3573,952,4525,completed
2205,rigid,10154,13734,15032,3580,1298,4878,completed
2206,rigid,10173,13734,13736,3561,2,3563,completed
2207,rigid,10179,13769,14233,3590,464,4054,completed
2208,rigid,10181,13777,14214,3596,437,4033,completed
2209,rigid,10181,13811,14398,3630,587,4217,completed
2210,rigid,10181,13811,14526,3630,715,4345,completed
2211,rigid,10181,13828,14526,3647,698,4345,completed
2212,rigid,10182,13845,14462,3663,617,4280,completed
2213,rigid,10182,13853,14398,3671,545,4216,completed
2214,rigid,10182,13865,14392,3683,527,4210,completed
2215,rigid,10182,13870,14277,3688,407,4095,completed
2216,rigid,10182,13874,14258,3692,384,4076,completed
2217,rigid,10182,13879,14224,3697,345,4042,completed
2218,rigid,10182,13879,14199,3697,320,4017,completed
2219,rigid,10198,13879,13883,3681,4,3685,completed
2220,rigid,10207,13879,13926,3672,47,3719,completed
2221,rigid,10208,13880,14104,3672,224,3896,completed
2222,rigid,10208,13883,14179,3675,296,3971,completed
2223,rigid,10208,13884,13900,3676,16,3692,completed
2224,rigid,10211,13890,15284,3679,1394,5073,completed
2225,rigid,10212,13890,15172,3678,1282,4960,completed
2226,rigid,10213,13895,15345,3682,1450,5132,completed
2227,rigid,10213,13898,13899,3685,1,3686,completed
2228,rigid,10214,13898,13901,3684,3,3687,completed
2229,rigid,10218,13898,13904,3680,6,3686,completed
2230,rigid,10221,13908,13921,3687,13,3700,completed
2231,rigid,10221,13909,13926,3688,17,3705,completed
2232,rigid,10222,13919,13942,3697,23,3720,completed
2233,rigid,10222,13921,15458,3699,1537,5236,completed
2234,rigid,10222,13921,13925,3699,4,3703,completed
2235,rigid,10223,13924,13946,3701,22,3723,completed
2236,rigid,10223,13925,13931,3702,6,3708,completed
2237,rigid,10223,13926,13950,3703,24,3727,completed
2238,rigid,10223,13936,15077,3713,1141,4854,completed
2239,rigid,10224,13946,15184,3722,1238,4960,completed
2240,rigid,10224,13970,15465,3746,1495,5241,completed
2241,rigid,10236,13970,15698,3734,1728,5462,completed
2242,rigid,10236,13970,15698,3734,1728,5462,completed
2243,rigid,10236,13970,15698,3734,1728,5462,completed
2244,rigid,10236,14005,15733,3769,1728,5497,completed
2245,rigid,10236,14005,15733,3769,1728,5497,completed
2246,rigid,10236,14005,15733,3769,1728,5497,completed
2247,rigid,10237,14005,15733,3768,1728,5496,completed
2248,rigid,10237,14055,15783,3818,1728,5546,completed
2249,rigid,10237,14055,15616,3818,1561,5379,completed
2250,rigid,10237,14055,15783,3818,1728,5546,completed
2251,rigid,10237,14055,15783,3818,1728,5546,completed
2252,rigid,10237,14066,15440,3829,1374,5203,completed
2253,rigid,10238,14101,15829,3863,1728,5591,completed
2254,rigid,10238,14104,15552,3866,1448,5314,completed
2255,rigid,10238,14107,15835,3869,1728,5597,completed
2256,rigid,10239,14116,14332,3877,216,4093,completed
2257,rigid,10239,14199,14416,3960,217,4177,completed
2258,rigid,10239,14199,15927,3960,1728,5688,completed
2259,rigid,10239,14199,15927,3960,1728,5688,completed
2260,rigid,10239,14199,14214,3960,15,3975,completed
2261,rigid,10239,14199,15927,3960,1728,5688,completed
2262,rigid,10239,14199,15927,3960,1728,5688,completed
2263,rigid,10239,14210,15938,3971,1728,5699,completed
2264,rigid,10240,14210,15074,3970,864,4834,completed
2265,rigid,10240,14210,15074,3970,864,4834,completed
2266,rigid,10240,14210,15074,3970,864,4834,completed
2267,rigid,10241,14214,15942,3973,1728,5701,completed
2268,rigid,10241,14214,15942,3973,1728,5701,completed
2269,rigid,10241,14214,15942,3973,1728,5701,completed
2270,rigid,10241,14214,14424,3973,210,4183,completed
2271,rigid,10241,14224,14432,3983,208,4191,completed
2272,rigid,10242,14224,15244,3982,1020,5002,completed
2273,rigid,10242,14224,15952,3982,1728,5710,completed
2274,rigid,10242,14227,15955,3985,1728,5713,completed
2275,rigid,10256,14233,14445,3977,212,4189,completed
2276,rigid,10256,14248,14462,3992,214,4206,completed
2277,rigid,10270,14258,14277,3988,19,4007,completed
2278,rigid,10270,14258,14282,3988,24,4012,completed
2279,rigid,10270,14277,14283,4007,6,4013,completed
2280,rigid,10270,14277,14341,4007,64,4071,completed
2281,rigid,10273,14277,14302,4004,25,4029,completed
2282,rigid,10273,14277,14292,4004,15,4019,completed
2283,rigid,10276,14277,14289,4001,12,4013,completed
2284,rigid,10280,14277,14278,3997,1,3998,completed
2285,rigid,10282,14277,14283,3995,6,4001,completed
2286,rigid,10282,14277,14295,3995,18,4013,completed
2287,rigid,10289,14277,14278,3988,1,3989,completed
2288,rigid,10290,14278,14303,3988,25,4013,completed
2289,rigid,10295,14282,14305,3987,23,4010,completed
2290,rigid,10301,14282,14289,3981,7,3988,completed
2291,rigid,10301,14282,14287,3981,5,3986,completed
2292,rigid,10301,14282,14291,3981,9,3990,completed
2293,rigid,10301,14282,14286,3981,4,3985,completed
2294,rigid,10301,14282,14294,3981,12,3993,completed
2295,rigid,10301,14282,14286,3981,4,3985,completed
2296,rigid,10301,14282,14291,3981,9,3990,completed
2297,rigid,10301,14282,14286,3981,4,3985,completed
2298,rigid,10301,14282,14295,3981,13,3994,completed
2299,rigid,10301,14282,14301,3981,19,4000,completed
2300,rigid,10301,14282,14289,3981,7,3988,completed
2301,rigid,10301,14282,14283,3981,1,3982,completed
2302,rigid,10301,14282,14286,3981,4,3985,completed
2303,rigid,10301,14282,14297,3981,15,3996,completed
2304,rigid,10301,14282,14306,3981,24,4005,completed
2305,rigid,10301,14282,14287,3981,5,3986,completed
2306,rigid,10301,14282,14293,3981,11,3992,completed
2307,rigid,10301,14282,14300,3981,18,3999,completed
2308,rigid,10301,14282,14294,3981,12,3993,completed
2309,rigid,10301,14282,14283,3981,1,3982,completed
2310,rigid,10301,14282,14287,3981,5,3986,completed
2311,rigid,10301,14282,14293,3981,11,3992,completed
2312,rigid,10301,14282,14293,3981,11,3992,completed
2313,rigid,10301,14282,14293,3981,11,3992,completed
2314,rigid,10301,14282,14292,3981,10,3991,completed
2315,rigid,10301,14282,14318,3981,36,4017,completed
2316,rigid,10301,14282,14291,3981,9,3990,completed
2317,rigid,10301,14282,14283,3981,1,3982,completed
2318,rigid,10301,14282,14286,3981,4,3985,completed
2319,rigid,10301,14282,14314,3981,32,4013,completed
2320,rigid,10301,14282,14287,3981,5,3986,completed
2321,rigid,10301,14282,14291,3981,9,3990,completed
2322,rigid,10301,14282,14287,3981,5,3986,completed
2323,rigid,10301,14282,14286,3981,4,3985,completed
2324,rigid,10301,14282,14291,3981,9,3990,completed
2325,rigid,10301,14282,14291,3981,9,3990,completed
2326,rigid,10301,14282,14299,3981,17,3998,completed
2327,rigid,10301,14282,14283,3981,1,3982,completed
2328,rigid,10301,14282,14300,3981,18,3999,completed
2329,rigid,10301,14282,14314,3981,32,4013,completed
2330,rigid,10301,14283,14294,3982,11,3993,completed
2331,rigid,10301,14283,14293,3982,10,3992,completed
2332,rigid,10301,14283,14286,3982,3,3985,completed
2333,rigid,10301,14283,14292,3982,9,3991,completed
2334,rigid,10303,14283,14295,3980,12,3992,completed
2335,rigid,10307,14283,14314,3976,31,4007,completed
2336,rigid,10308,14283,14291,3975,8,3983,completed
2337,rigid,10328,14291,14306,3963,15,3978,completed
2338,rigid,10337,14291,14317,3954,26,3980,completed
2339,rigid,10348,14294,14295,3946,1,3947,completed
2340,rigid,10348,14295,14361,3947,66,4013,completed
2341,rigid,10348,14295,14362,3947,67,4014,completed
2342,rigid,10352,14295,14311,3943,16,3959,completed
2343,rigid,10357,14344,15776,3987,1432,5419,completed
2344,rigid,10357,14398,15881,4041,1483,5524,completed
2345,rigid,10359,14416,14667,4057,251,4308,completed
2346,rigid,10373,14416,17872,4043,3456,7499,completed
2347,rigid,10374,14416,17872,4042,3456,7498,completed
2348,rigid,10374,14416,17872,4042,3456,7498,completed
2349,rigid,10374,14416,17872,4042,3456,7498,completed
2350,rigid,10374,14416,17872,4042,3456,7498,completed
2351,rigid,10374,14416,17872,4042,3456,7498,completed
2352,rigid,10374,14416,17872,4042,3456,7498,completed
2353,rigid,10374,14416,17872,4042,3456,7498,completed
2354,rigid,10374,14416,17872,4042,3456,7498,completed
2355,rigid,10374,14416,17872,4042,3456,7498,completed
2356,rigid,10374,14416,17872,4042,3456,7498,completed
2357,rigid,10374,14416,17872,4042,3456,7498,completed
2358,rigid,10374,14416,17872,4042,3456,7498,completed
2359,rigid,10374,14416,17872,4042,3456,7498,completed
2360,rigid,10374,14416,17872,4042,3456,7498,completed
2361,rigid,10374,14424,17880,4050,3456,7506,completed
2362,rigid,10374,14424,17880,4050,3456,7506,completed
2363,rigid,10374,14424,17880,4050,3456,7506,completed
2364,rigid,10374,14424,17880,4050,3456,7506,completed
2365,rigid,10374,14424,17880,4050,3456,7506,completed
2366,rigid,10374,14424,17880,4050,3456,7506,completed
2367,rigid,10374,14424,17880,4050,3456,7506,completed
2368,rigid,10374,14424,17880,4050,3456,7506,completed
2369,rigid,10374,14424,17880,4050,3456,7506,completed
2370,rigid,10374,14424,17880,4050,3456,7506,completed
2371,rigid,10374,14424,17880,4050,3456,7506,completed
2372,rigid,10374,14424,17880,4050,3456,7506,completed
2373,rigid,10374,14424,17880,4050,3456,7506,completed
2374,rigid,10374,14424,17880,4050,3456,7506,completed
2375,rigid,10374,14424,17880,4050,3456,7506,completed
2376,rigid,10374,14424,17880,4050,3456,7506,completed
2377,rigid,10374,14424,17880,4050,3456,7506,completed
2378,rigid,10374,14424,17880,4050,3456,7506,completed
2379,rigid,10374,14424,17880,4050,3456,7506,completed
2380,rigid,10374,14424,17880,4050,3456,7506,completed
2381,rigid,10374,14424,17880,4050,3456,7506,completed
2382,rigid,10374,14424,17880,4050,3456,7506,completed
2383,rigid,10374,14424,17880,4050,3456,7506,completed
2384,rigid,10374,14424,17880,4050,3456,7506,completed
2385,rigid,10374,14424,17880,4050,3456,7506,completed
2386,rigid,10374,14424,17880,4050,3456,7506,completed
2387,rigid,10374,14424,17880,4050,3456,7506,completed
2388,rigid,10374,14424,17880,4050,3456,7506,completed
2389,rigid,10374,14424,17880,4050,3456,7506,completed
2390,rigid,10374,14424,17880,4050,3456,7506,completed
2391,rigid,10374,14424,17880,4050,3456,7506,completed
2392,rigid,10374,14424,17880,4050,3456,7506,completed
2393,rigid,10374,14424,17880,4050,3456,7506,completed
2394,rigid,10374,14424,17880,4050,3456,7506,completed
2395,rigid,10374,14424,17880,4050,3456,7506,completed
2396,rigid,10374,14424,17880,4050,3456,7506,completed
2397,rigid,10374,14424,17880,4050,3456,7506,completed
2398,rigid,10374,14424,17880,4050,3456,7506,completed
2399,rigid,10374,14424,17880,4050,3456,7506,completed
2400,rigid,10374,14424,17880,4050,3456,7506,completed
2401,rigid,10374,14424,17880,4050,3456,7506,completed
2402,rigid,10374,14424,17880,4050,3456,7506,completed
2403,rigid,10374,14424,17880,4050,3456,7506,completed
2404,rigid,10374,14424,17880,4050,3456,7506,completed
2405,rigid,10374,14424,17880,4050,3456,7506,completed
2406,rigid,10375,14424,14436,4049,12,4061,completed
2407,rigid,10376,14424,17880,4048,3456,7504,completed
2408,rigid,10377,14424,17880,4047,3456,7503,completed
2409,rigid,10377,14424,17880,4047,3456,7503,completed
2410,rigid,10377,14424,17880,4047,3456,7503,completed
2411,rigid,10377,14424,17880,4047,3456,7503,completed
2412,rigid,10382,14432,16876,4050,2444,6494,completed
2413,rigid,10387,14445,14506,4058,61,4119,completed
2414,rigid,10387,14456,36717,4069,22261,26330,completed
2415,rigid,10388,14462,14463,4074,1,4075,completed
2416,rigid,10389,14462,14463,4073,1,4074,completed
2417,rigid,10390,14462,14472,4072,10,4082,completed
2418,rigid,10391,14462,14475,4071,13,4084,completed
2419,rigid,10391,14462,14466,4071,4,4075,completed
2420,rigid,10391,14462,14468,4071,6,4077,completed
2421,rigid,10391,14462,14477,4071,15,4086,completed
2422,rigid,10393,14462,14638,4069,176,4245,completed
2423,rigid,10395,14462,14523,4067,61,4128,completed
2424,rigid,10397,14466,14527,4069,61,4130,completed
2425,rigid,10397,14506,14567,4109,61,4170,completed
2426,rigid,10399,14506,14676,4107,170,4277,completed
2427,rigid,10399,14523,14584,4124,61,4185,completed
2428,rigid,10401,14523,14527,4122,4,4126,completed
2429,rigid,10402,14526,14586,4124,60,4184,completed
2430,rigid,10402,14526,14528,4124,2,4126,completed
2431,rigid,10402,14526,17982,4124,3456,7580,completed
2432,rigid,10402,14526,17982,4124,3456,7580,completed
2433,rigid,10402,14526,17982,4124,3456,7580,completed
2434,rigid,10402,14526,17982,4124,3456,7580,completed
2435,rigid,10402,14526,17982,4124,3456,7580,completed
2436,rigid,10403,14526,17982,4123,3456,7579,completed
2437,rigid,10403,14526,17982,4123,3456,7579,completed
2438,rigid,10403,14526,17982,4123,3456,7579,completed
2439,rigid,10403,14526,17982,4123,3456,7579,completed
2440,rigid,10403,14526,17982,4123,3456,7579,completed
2441,rigid,10408,14526,14533,4118,7,4125,completed
2442,rigid,10408,14526,15486,4118,960,5078,completed
2443,rigid,10408,14526,15985,4118,1459,5577,completed
2444,rigid,10408,14526,15020,4118,494,4612,completed
2445,rigid,10409,14526,16049,4117,1523,5640,completed
2446,rigid,10409,14526,15312,4117,786,4903,completed
2447,rigid,10409,14526,15573,4117,1047,5164,completed
2448,rigid,10410,14526,15767,4116,1241,5357,completed
2449,rigid,10410,14526,15678,4116,1152,5268,completed
2450,rigid,10410,14527,15692,4117,1165,5282,completed
2451,rigid,10410,14527,14586,4117,59,4176,completed
2452,rigid,10412,14527,14528,4115,1,4116,completed
2453,rigid,10412,14527,14528,4115,1,4116,completed
2454,rigid,10412,14527,14528,4115,1,4116,completed
2455,rigid,10412,14527,14528,4115,1,4116,completed
2456,rigid,10412,14527,14528,4115,1,4116,completed
2457,rigid,10412,14527,14528,4115,1,4116,completed
2458,rigid,10412,14527,14528,4115,1,4116,completed
2459,rigid,10412,14527,14528,4115,1,4116,completed
2460,rigid,10412,14527,14565,4115,38,4153,completed
2461,rigid,10412,14527,14563,4115,36,4151,completed
2462,rigid,10412,14527,14560,4115,33,4148,completed
2463,rigid,10412,14527,14575,4115,48,4163,completed
2464,rigid,10412,14528,14588,4116,60,4176,completed
2465,rigid,10412,14528,14557,4116,29,4145,completed
2466,rigid,10412,14528,14584,4116,56,4172,completed
2467,rigid,10412,14528,14529,4116,1,4117,completed
2468,rigid,10412,14528,14529,4116,1,4117,completed
2469,rigid,10412,14528,14529,4116,1,4117,completed
2470,rigid,10412,14528,14558,4116,30,4146,completed
2471,rigid,10412,14528,16256,4116,1728,5844,completed
2472,rigid,10412,14533,16261,4121,1728,5849,completed
2473,rigid,10413,14567,14582,4154,15,4169,completed
2474,rigid,10413,14582,14597,4169,15,4184,completed
2475,rigid,10413,14584,14599,4171,15,4186,completed
2476,rigid,10413,14586,14601,4173,15,4188,completed
2477,rigid,10413,14586,14601,4173,15,4188,completed
2478,rigid,10413,14597,14612,4184,15,4199,completed
2479,rigid,10413,14599,14614,4186,15,4201,completed
2480,rigid,10413,14601,14616,4188,15,4203,completed
2481,rigid,10413,14601,14616,4188,15,4203,completed
2482,rigid,10413,14611,14626,4198,15,4213,completed
2483,rigid,10413,14611,14626,4198,15,4213,completed
2484,rigid,10413,14611,14626,4198,15,4213,completed
2485,rigid,10413,14611,14626,4198,15,4213,completed
2486,rigid,10413,14611,14626,4198,15,4213,completed
2487,rigid,10413,14612,14627,4199,15,4214,completed
2488,rigid,10413,14614,14629,4201,15,4216,completed
2489,rigid,10413,14616,14631,4203,15,4218,completed
2490,rigid,10413,14616,14631,4203,15,4218,completed
2491,rigid,10413,14626,14641,4213,15,4228,completed
2492,rigid,10413,14626,14641,4213,15,4228,completed
2493,rigid,10413,14626,14641,4213,15,4228,completed
2494,rigid,10413,14626,14642,4213,16,4229,completed
2495,rigid,10413,14626,14642,4213,16,4229,completed
2496,rigid,10413,14627,14643,4214,16,4230,completed
2497,rigid,10413,14629,14645,4216,16,4232,completed
2498,rigid,10413,14630,14646,4217,16,4233,completed
2499,rigid,10413,14631,14647,4218,16,4234,completed
2500,rigid,10413,14631,14647,4218,16,4234,completed
2501,rigid,10413,14641,14657,4228,16,4244,completed
2502,rigid,10413,14641,14657,4228,16,4244,completed
2503,rigid,10413,14641,14657,4228,16,4244,completed
2504,rigid,10413,14642,14658,4229,16,4245,completed
2505,rigid,10413,14642,14658,4229,16,4245,completed
2506,rigid,10413,14643,14659,4230,16,4246,completed
2507,rigid,10413,14645,14661,4232,16,4248,completed
2508,rigid,10413,14646,14661,4233,15,4248,completed
2509,rigid,10415,14647,14704,4232,57,4289,completed
2510,rigid,10418,14647,14648,4229,1,4230,completed
2511,rigid,10418,14647,14648,4229,1,4230,completed
2512,rigid,10418,14647,14649,4229,2,4231,completed
2513,rigid,10418,14647,14648,4229,1,4230,completed
2514,rigid,10418,14647,14648,4229,1,4230,completed
2515,rigid,10418,14647,14649,4229,2,4231,completed
2516,rigid,10418,14647,14648,4229,1,4230,completed
2517,rigid,10418,14647,14648,4229,1,4230,completed
2518,rigid,10418,14647,14649,4229,2,4231,completed
2519,rigid,10418,14647,14648,4229,1,4230,completed
2520,rigid,10418,14647,14648,4229,1,4230,completed
2521,rigid,10418,14647,14648,4229,1,4230,completed
2522,rigid,10418,14647,14648,4229,1,4230,completed
2523,rigid,10418,14647,14648,4229,1,4230,completed
2524,rigid,10418,14647,14648,4229,1,4230,completed
2525,rigid,10418,14647,14648,4229,1,4230,completed
2526,rigid,10418,14647,14648,4229,1,4230,completed
2527,rigid,10418,14647,14648,4229,1,4230,completed
2528,rigid,10418,14647,14648,4229,1,4230,completed
2529,rigid,10418,14647,14648,4229,1,4230,completed
2530,rigid,10418,14647,14648,4229,1,4230,completed
2531,rigid,10418,14647,14648,4229,1,4230,completed
2532,rigid,10418,14647,14665,4229,18,4247,completed
2533,rigid,10418,14647,14656,4229,9,4238,completed
2534,rigid,10418,14647,14658,4229,11,4240,completed
2535,rigid,10418,14647,14681,4229,34,4263,completed
2536,rigid,10418,14647,14667,4229,20,4249,completed
2537,rigid,10418,14647,14662,4229,15,4244,completed
2538,rigid,10418,14647,14662,4229,15,4244,completed
2539,rigid,10418,14647,14680,4229,33,4262,completed
2540,rigid,10418,14647,14679,4229,32,4261,completed
2541,rigid,10418,14647,14655,4229,8,4237,completed
2542,rigid,10418,14647,14659,4229,12,4241,completed
2543,rigid,10418,14647,14668,4229,21,4250,completed
2544,rigid,10418,14647,14699,4229,52,4281,completed
2545,rigid,10418,14647,14662,4229,15,4244,completed
2546,rigid,10418,14647,14670,4229,23,4252,completed
2547,rigid,10418,14647,14656,4229,9,4238,completed
2548,rigid,10418,14647,14657,4229,10,4239,completed
2549,rigid,10418,14647,14661,4229,14,4243,completed
2550,rigid,10418,14647,14670,4229,23,4252,completed
2551,rigid,10418,14647,14662,4229,15,4244,completed
2552,rigid,10418,14647,14725,4229,78,4307,completed
2553,rigid,10418,14647,14665,4229,18,4247,completed
2554,rigid,10418,14647,14659,4229,12,4241,completed
2555,rigid,10418,14647,14694,4229,47,4276,completed
2556,rigid,10418,14647,14657,4229,10,4239,completed
2557,rigid,10418,14647,14655,4229,8,4237,completed
2558,rigid,10418,14647,14719,4229,72,4301,completed
2559,rigid,10418,14647,14657,4229,10,4239,completed
2560,rigid,10418,14647,14657,4229,10,4239,completed
2561,rigid,10418,14647,14653,4229,6,4235,completed
2562,rigid,10418,14647,14657,4229,10,4239,completed
2563,rigid,10418,14647,14682,4229,35,4264,completed
2564,rigid,10418,14647,14662,4229,15,4244,completed
2565,rigid,10418,14647,14653,4229,6,4235,completed
2566,rigid,10418,14647,14673,4229,26,4255,completed
2567,rigid,10418,14647,14661,4229,14,4243,completed
2568,rigid,10418,14647,14651,4229,4,4233,completed
2569,rigid,10418,14647,14651,4229,4,4233,completed
2570,rigid,10418,14647,14651,4229,4,4233,completed
2571,rigid,10418,14647,14661,4229,14,4243,completed
2572,rigid,10418,14647,14673,4229,26,4255,completed
2573,rigid,10418,14647,14661,4229,14,4243,completed
2574,rigid,10418,14647,14671,4229,24,4253,completed
2575,rigid,10418,14647,14671,4229,24,4253,completed
2576,rigid,10418,14647,14661,4229,14,4243,completed
2577,rigid,10418,14647,14651,4229,4,4233,completed
2578,rigid,10418,14647,14650,4229,3,4232,completed
2579,rigid,10418,14647,14650,4229,3,4232,completed
2580,rigid,10418,14647,14661,4229,14,4243,completed
2581,rigid,10418,14647,14651,4229,4,4233,completed
2582,rigid,10418,14647,14666,4229,19,4248,completed
2583,rigid,10418,14647,14661,4229,14,4243,completed
2584,rigid,10418,14647,14666,4229,19,4248,completed
2585,rigid,10418,14647,14670,4229,23,4252,completed
2586,rigid,10418,14647,14660,4229,13,4242,completed
2587,rigid,10418,14647,14670,4229,23,4252,completed
2588,rigid,10418,14647,14651,4229,4,4233,completed
2589,rigid,10418,14647,14650,4229,3,4232,completed
2590,rigid,10418,14647,14650,4229,3,4232,completed
2591,rigid,10418,14647,14668,4229,21,4250,completed
2592,rigid,10418,14647,14660,4229,13,4242,completed
2593,rigid,10418,14647,14660,4229,13,4242,completed
2594,rigid,10418,14647,14649,4229,2,4231,completed
2595,rigid,10418,14647,14649,4229,2,4231,completed
2596,rigid,10418,14647,14648,4229,1,4230,completed
2597,rigid,10418,14647,14653,4229,6,4235,completed
2598,rigid,10418,14647,14660,4229,13,4242,completed
2599,rigid,10418,14647,14668,4229,21,4250,completed
2600,rigid,10418,14647,14658,4229,11,4240,completed
2601,rigid,10418,14647,14653,4229,6,4235,completed
2602,rigid,10418,14647,14648,4229,1,4230,completed
2603,rigid,10418,14647,14658,4229,11,4240,completed
2604,rigid,10418,14647,14648,4229,1,4230,completed
2605,rigid,10418,14647,14648,4229,1,4230,completed
2606,rigid,10418,14647,14650,4229,3,4232,completed
2607,rigid,10418,14647,14658,4229,11,4240,completed
2608,rigid,10419,14647,14649,4228,2,4230,completed
2609,rigid,10419,14647,14658,4228,11,4239,completed
2610,rigid,10420,14647,14657,4227,10,4237,completed
2611,rigid,10420,14647,14657,4227,10,4237,completed
2612,rigid,10420,14647,14661,4227,14,4241,completed
2613,rigid,10420,14647,14661,4227,14,4241,completed
2614,rigid,10420,14647,14652,4227,5,4232,completed
2615,rigid,10420,14647,14652,4227,5,4232,completed
2616,rigid,10420,14647,14652,4227,5,4232,completed
2617,rigid,10420,14647,14652,4227,5,4232,completed
2618,rigid,10420,14647,14651,4227,4,4231,completed
2619,rigid,10420,14647,14649,4227,2,4229,completed
2620,rigid,10420,14647,14651,4227,4,4231,completed
2621,rigid,10420,14647,14649,4227,2,4229,completed
2622,rigid,10420,14647,14649,4227,2,4229,completed
2623,rigid,10421,14647,14649,4226,2,4228,completed
2624,rigid,10422,14647,15381,4225,734,4959,completed
2625,rigid,10422,14649,17241,4227,2592,6819,completed
2626,rigid,10422,14651,14730,4229,79,4308,completed
2627,rigid,10422,14657,15193,4235,536,4771,completed
2628,rigid,10422,14657,15124,4235,467,4702,completed
2629,rigid,10422,14657,15497,4235,840,5075,completed
2630,rigid,10422,14657,15344,4235,687,4922,completed
2631,rigid,10422,14657,15640,4235,983,5218,completed
2632,rigid,10422,14657,15039,4235,382,4617,completed
2633,rigid,10422,14657,14717,4235,60,4295,completed
2634,rigid,10422,14657,17249,4235,2592,6827,completed
2635,rigid,10422,14657,14864,4235,207,4442,completed
2636,rigid,10422,14657,17081,4235,2424,6659,completed
2637,rigid,10422,14657,17249,4235,2592,6827,completed
2638,rigid,10422,14657,15099,4235,442,4677,completed
2639,rigid,10422,14657,16184,4235,1527,5762,completed
2640,rigid,10422,14658,14933,4236,275,4511,completed
2641,rigid,10422,14658,16325,4236,1667,5903,completed
2642,rigid,10422,14658,17250,4236,2592,6828,completed
2643,rigid,10422,14658,17250,4236,2592,6828,completed
2644,rigid,10422,14658,16918,4236,2260,6496,completed
2645,rigid,10422,14658,14696,4236,38,4274,completed
2646,rigid,10422,14658,16955,4236,2297,6533,completed
2647,rigid,10422,14658,14815,4236,157,4393,completed
2648,rigid,10422,14659,14696,4237,37,4274,completed
2649,rigid,10422,14659,16204,4237,1545,5782,completed
2650,rigid,10422,14659,15014,4237,355,4592,completed
2651,rigid,10422,14659,17251,4237,2592,6829,completed
2652,rigid,10422,14660,16370,4238,1710,5948,completed
2653,rigid,10422,14661,15450,4239,789,5028,completed
2654,rigid,10422,14661,16056,4239,1395,5634,completed
2655,rigid,10422,14661,15190,4239,529,4768,completed
2656,rigid,10422,14661,14701,4239,40,4279,completed
2657,rigid,10422,14661,14751,4239,90,4329,completed
2658,rigid,10422,14661,14941,4239,280,4519,completed
2659,rigid,10422,14661,17253,4239,2592,6831,completed
2660,rigid,10422,14661,17253,4239,2592,6831,completed
2661,rigid,10422,14661,14902,4239,241,4480,completed
2662,rigid,10422,14663,17255,4241,2592,6833,completed
2663,rigid,10422,14667,15401,4245,734,4979,completed
2664,rigid,10422,14667,14845,4245,178,4423,completed
2665,rigid,10422,14667,17259,4245,2592,6837,completed
2666,rigid,10422,14667,16123,4245,1456,5701,completed
2667,rigid,10422,14676,17268,4254,2592,6846,completed
2668,rigid,10422,14679,16055,4257,1376,5633,completed
2669,rigid,10422,14696,15236,4274,540,4814,completed
2670,rigid,10422,14696,15180,4274,484,4758,completed
2671,rigid,10422,14701,17293,4279,2592,6871,completed
2672,rigid,10422,14704,15312,4282,608,4890,completed
2673,rigid,10422,14704,15816,4282,1112,5394,completed
2674,rigid,10422,14704,17296,4282,2592,6874,completed
2675,rigid,10422,14704,15830,4282,1126,5408,completed
2676,rigid,10422,14717,15908,4295,1191,5486,completed
2677,rigid,10422,14729,16555,4307,1826,6133,completed
2678,rigid,10422,14729,15588,4307,859,5166,completed
2679,rigid,10422,14729,14933,4307,204,4511,completed
2680,rigid,10422,14730,17322,4308,2592,6900,completed
2681,rigid,10422,14739,14919,4317,180,4497,completed
2682,rigid,10422,14751,17343,4329,2592,6921,completed
2683,rigid,10422,14763,15124,4341,361,4702,completed
2684,rigid,10422,14795,15323,4373,528,4901,completed
2685,rigid,10422,14795,17387,4373,2592,6965,completed
2686,rigid,10422,14795,17387,4373,2592,6965,completed
2687,rigid,10422,14795,17387,4373,2592,6965,completed
2688,rigid,10422,14795,17387,4373,2592,6965,completed
2689,rigid,10422,14795,17387,4373,2592,6965,completed
2690,rigid,10422,14795,17387,4373,2592,6965,completed
2691,rigid,10422,14815,17407,4393,2592,6985,completed
2692,rigid,10422,14827,17419,4405,2592,6997,completed
2693,rigid,10422,14827,15734,4405,907,5312,completed
2694,rigid,10422,14827,15129,4405,302,4707,completed
2695,rigid,10422,14827,15019,4405,192,4597,completed
2696,rigid,10422,14845,15578,4423,733,5156,completed
2697,rigid,10422,14860,15254,4438,394,4832,completed
2698,rigid,10422,14860,15198,4438,338,4776,completed
2699,rigid,10422,14860,16310,4438,1450,5888,completed
2700,rigid,10422,14860,17452,4438,2592,7030,completed
2701,rigid,10422,14864,15664,4442,800,5242,completed
2702,rigid,10422,14872,15584,4450,712,5162,completed
2703,rigid,10422,14872,16030,4450,1158,5608,completed
2704,rigid,10422,14872,17464,4450,2592,7042,completed
2705,rigid,10422,14875,17467,4453,2592,7045,completed
2706,rigid,10422,14877,17469,4455,2592,7047,completed
2707,rigid,10422,14885,15273,4463,388,4851,completed
2708,rigid,10422,14885,15698,4463,813,5276,completed
2709,rigid,10422,14885,17477,4463,2592,7055,completed
2710,rigid,10422,14898,16292,4476,1394,5870,completed
2711,rigid,10422,14902,17494,4480,2592,7072,completed
2712,rigid,10422,14907,16822,4485,1915,6400,completed
2713,rigid,10422,14919,17511,4497,2592,7089,completed
2714,rigid,10422,14930,15048,4508,118,4626,completed
2715,rigid,10422,14930,15316,4508,386,4894,completed
2716,rigid,10422,14933,15214,4511,281,4792,completed
2717,rigid,10422,14941,15440,4519,499,5018,completed
2718,rigid,10422,14960,15471,4538,511,5049,completed
2719,rigid,10422,14960,15424,4538,464,5002,completed
2720,rigid,10422,14996,15510,4574,514,5088,completed
2721,rigid,10422,15019,15579,4597,560,5157,completed
2722,rigid,10422,15029,15266,4607,237,4844,completed
2723,rigid,10422,15029,15324,4607,295,4902,completed
2724,rigid,10422,15032,15538,4610,506,5116,completed
2725,rigid,10422,15048,15483,4626,435,5061,completed
2726,rigid,10422,15073,16135,4651,1062,5713,completed
2727,rigid,10422,15073,16258,4651,1185,5836,completed
2728,rigid,10422,15074,16275,4652,1201,5853,completed
2729,rigid,10422,15074,15350,4652,276,4928,completed
2730,rigid,10422,15077,17669,4655,2592,7247,completed
2731,rigid,10422,15077,16456,4655,1379,6034,completed
2732,rigid,10422,15077,17669,4655,2592,7247,completed
2733,rigid,10422,15077,17669,4655,2592,7247,completed
2734,rigid,10422,15077,17669,4655,2592,7247,completed
2735,rigid,10422,15077,17669,4655,2592,7247,completed
2736,rigid,10422,15077,16208,4655,1131,5786,completed
2737,rigid,10422,15077,15603,4655,526,5181,completed
2738,rigid,10422,15099,17691,4677,2592,7269,completed
2739,rigid,10422,15107,17699,4685,2592,7277,completed
2740,rigid,10422,15115,17707,4693,2592,7285,completed
2741,rigid,10422,15124,15638,4702,514,5216,completed
2742,rigid,10422,15124,15595,4702,471,5173,completed
2743,rigid,10422,15129,17721,4707,2592,7299,completed
2744,rigid,10422,15145,15505,4723,360,5083,completed
2745,rigid,10422,15145,17737,4723,2592,7315,completed
2746,rigid,10422,15145,17737,4723,2592,7315,completed
2747,rigid,10422,15145,17737,4723,2592,7315,completed
2748,rigid,10422,15172,17764,4750,2592,7342,completed
2749,rigid,10422,15172,17764,4750,2592,7342,completed
2750,rigid,10422,15172,15410,4750,238,4988,completed
2751,rigid,10422,15172,15449,4750,277,5027,completed
2752,rigid,10422,15180,16785,4758,1605,6363,completed
2753,rigid,10422,15184,17776,4762,2592,7354,completed
2754,rigid,10422,15184,15650,4762,466,5228,completed
2755,rigid,10422,15184,15306,4762,122,4884,completed
2756,rigid,10422,15184,15705,4762,521,5283,completed
2757,rigid,10422,15184,15408,4762,224,4986,completed
2758,rigid,10422,15184,17776,4762,2592,7354,completed
2759,rigid,10422,15184,15727,4762,543,5305,completed
2760,rigid,10422,15184,17776,4762,2592,7354,completed
2761,rigid,10422,15184,17295,4762,2111,6873,completed
2762,rigid,10422,15184,15242,4762,58,4820,completed
2763,rigid,10422,15190,15366,4768,176,4944,completed
2764,rigid,10422,15193,15313,4771,120,4891,completed
2765,rigid,10422,15198,15975,4776,777,5553,completed
2766,rigid,10422,15206,15686,4784,480,5264,completed
2767,rigid,10438,15214,15215,4776,1,4777,completed
2768,rigid,10438,15215,15222,4777,7,4784,completed
2769,rigid,10438,15222,15226,4784,4,4788,completed
2770,rigid,10438,15226,15229,4788,3,4791,completed
2771,rigid,10438,15229,15233,4791,4,4795,completed
2772,rigid,10438,15233,15234,4795,1,4796,completed
2773,rigid,10438,15234,15237,4796,3,4799,completed
2774,rigid,10438,15237,15240,4799,3,4802,completed
2775,rigid,10438,15240,15243,4802,3,4805,completed
2776,rigid,10438,15241,15247,4803,6,4809,completed
2777,rigid,10438,15243,15246,4805,3,4808,completed
2778,rigid,10438,15244,15252,4806,8,4814,completed
2779,rigid,10438,15246,15249,4808,3,4811,completed
2780,rigid,10438,15247,15250,4809,3,4812,completed
2781,rigid,10438,15249,15252,4811,3,4814,completed
2782,rigid,10439,15249,15598,4810,349,5159,completed
2783,rigid,10439,15250,15751,4811,501,5312,completed
2784,rigid,10439,15252,15758,4813,506,5319,completed
2785,rigid,10439,15252,15704,4813,452,5265,completed
2786,rigid,10439,15273,15684,4834,411,5245,completed
2787,rigid,10439,15284,15692,4845,408,5253,completed
2788,rigid,10439,15304,15811,4865,507,5372,completed
2789,rigid,10439,15313,15837,4874,524,5398,completed
2790,rigid,10439,15324,15878,4885,554,5439,completed
2791,rigid,10439,15345,15796,4906,451,5357,completed
2792,rigid,10439,15350,15758,4911,408,5319,completed
2793,rigid,10439,15408,16038,4969,630,5599,completed
2794,rigid,10439,15440,15855,5001,415,5416,completed
2795,rigid,10439,15449,15893,5010,444,5454,completed
2796,rigid,10439,15458,15948,5019,490,5509,completed
2797,rigid,10439,15458,15819,5019,361,5380,completed
2798,rigid,10439,15465,15949,5026,484,5510,completed
2799,rigid,10439,15465,15982,5026,517,5543,completed
2800,rigid,10439,15465,15944,5026,479,5505,completed
2801,rigid,10439,15483,15950,5044,467,5511,completed
2802,rigid,10439,15505,16020,5066,515,5581,completed
2803,rigid,10439,15522,15978,5083,456,5539,completed
2804,rigid,10439,15538,16001,5099,463,5562,completed
2805,rigid,10439,15554,16115,5115,561,5676,completed
2806,rigid,10439,15573,15999,5134,426,5560,completed
2807,rigid,10439,15584,16105,5145,521,5666,completed
2808,rigid,10439,15616,16093,5177,477,5654,completed
2809,rigid,10439,15617,16055,5178,438,5616,completed
2810,rigid,10439,15650,15992,5211,342,5553,completed
2811,rigid,10439,15659,16004,5220,345,5565,completed
2812,rigid,10439,15684,16104,5245,420,5665,completed
2813,rigid,10439,15686,16129,5247,443,5690,completed
2814,rigid,10439,15692,16175,5253,483,5736,completed
2815,rigid,10439,15698,16034,5259,336,5595,completed
2816,rigid,10439,15704,16149,5265,445,5710,completed
2817,rigid,10439,15713,16119,5274,406,5680,completed
2818,rigid,10439,15715,16174,5276,459,5735,completed
2819,rigid,10439,15733,16243,5294,510,5804,completed
2820,rigid,10439,15734,16206,5295,472,5767,completed
2821,rigid,10439,15751,16173,5312,422,5734,completed
2822,rigid,10439,15758,16311,5319,553,5872,completed
2823,rigid,10439,15758,16295,5319,537,5856,completed
2824,rigid,10439,15761,16116,5322,355,5677,completed
2825,rigid,10439,15776,16368,5337,592,5929,completed
2826,rigid,10439,15776,16237,5337,461,5798,completed
2827,rigid,10439,15776,16204,5337,428,5765,completed
2828,rigid,10439,15776,16319,5337,543,5880,completed
2829,rigid,10439,15776,16221,5337,445,5782,completed
2830,rigid,10439,15776,16181,5337,405,5742,completed
2831,rigid,10439,15796,16275,5357,479,5836,completed
2832,rigid,10439,15811,16217,5372,406,5778,completed
2833,rigid,10441,15811,15819,5370,8,5378,completed
2834,rigid,10442,15811,15934,5369,123,5492,completed
2835,rigid,10442,15811,15839,5369,28,5397,completed
2836,rigid,10442,15811,15867,5369,56,5425,completed
2837,rigid,10442,15816,15919,5374,103,5477,completed
2838,rigid,10442,15819,16318,5377,499,5876,completed
2839,rigid,10442,15819,15908,5377,89,5466,completed
2840,rigid,10442,15819,16192,5377,373,5750,completed
2841,rigid,10442,15819,15838,5377,19,5396,completed
2842,rigid,10442,15829,16202,5387,373,5760,completed
2843,rigid,10442,15830,15996,5388,166,5554,completed
2844,rigid,10442,15835,16039,5393,204,5597,completed
2845,rigid,10442,15837,15967,5395,130,5525,completed
2846,rigid,10442,15837,16264,5395,427,5822,completed
2847,rigid,10442,15837,15870,5395,33,5428,completed
2848,rigid,10442,15837,15851,5395,14,5409,completed
2849,rigid,10442,15838,15869,5396,31,5427,completed
2850,rigid,10442,15839,15868,5397,29,5426,completed
2851,rigid,10442,15851,16266,5409,415,5824,completed
2852,rigid,10442,15855,16148,5413,293,5706,completed
2853,rigid,10442,15855,15875,5413,20,5433,completed
2854,rigid,10443,15855,15864,5412,9,5421,completed
2855,rigid,10445,15855,15864,5410,9,5419,completed
2856,rigid,10448,15855,15864,5407,9,5416,completed
2857,rigid,10449,15855,15929,5406,74,5480,completed
2858,rigid,10449,15855,15964,5406,109,5515,completed
2859,rigid,10449,15867,16000,5418,133,5551,completed
2860,rigid,10450,15867,15893,5417,26,5443,completed
2861,rigid,10450,15867,15877,5417,10,5427,completed
2862,rigid,10452,15867,15897,5415,30,5445,completed
2863,rigid,10455,15867,15900,5412,33,5445,completed
2864,rigid,10458,15867,15900,5409,33,5442,completed
2865,rigid,10461,15867,15881,5406,14,5420,completed
2866,rigid,10461,15867,15902,5406,35,5441,completed
2867,rigid,10463,15867,15873,5404,6,5410,completed
2868,rigid,10468,15867,15977,5399,110,5509,completed
2869,rigid,10472,15868,15984,5396,116,5512,completed
2870,rigid,10475,15868,15919,5393,51,5444,completed
2871,rigid,10477,15868,15888,5391,20,5411,completed
2872,rigid,10482,15868,15888,5386,20,5406,completed
2873,rigid,10489,15868,15891,5379,23,5402,completed
2874,rigid,10492,15868,15893,5376,25,5401,completed
2875,rigid,10496,15878,16572,5382,694,6076,completed
2876,rigid,10496,15878,15901,5382,23,5405,completed
2877,rigid,10496,15878,15902,5382,24,5406,completed
2878,rigid,10496,15878,15902,5382,24,5406,completed
2879,rigid,10496,15878,15902,5382,24,5406,completed
2880,rigid,10497,15878,15879,5381,1,5382,completed
2881,rigid,10497,15878,15887,5381,9,5390,completed
2882,rigid,10497,15878,15892,5381,14,5395,completed
2883,rigid,10497,15878,15889,5381,11,5392,completed
2884,rigid,10497,15878,15912,5381,34,5415,completed
2885,rigid,10498,15878,15906,5380,28,5408,completed
2886,rigid,10503,15878,15888,5375,10,5385,completed
2887,rigid,10503,15878,15894,5375,16,5391,completed
2888,rigid,10503,15878,15879,5375,1,5376,completed
2889,rigid,10503,15878,15890,5375,12,5387,completed
2890,rigid,10503,15878,15914,5375,36,5411,completed
2891,rigid,10512,15878,15880,5366,2,5368,completed
2892,rigid,10512,15878,15879,5366,1,5367,completed
2893,rigid,10512,15878,15890,5366,12,5378,completed
2894,rigid,10512,15878,15918,5366,40,5406,completed
2895,rigid,10512,15878,15888,5366,10,5376,completed
2896,rigid,10512,15878,15896,5366,18,5384,completed
2897,rigid,10513,15881,15885,5368,4,5372,completed
2898,rigid,10513,15881,15894,5368,13,5381,completed
2899,rigid,10513,15881,15895,5368,14,5382,completed
2900,rigid,10514,15881,15884,5367,3,5370,completed
2901,rigid,10514,15881,15891,5367,10,5377,completed
2902,rigid,10514,15884,15895,5370,11,5381,completed
2903,rigid,10517,15884,15886,5367,2,5369,completed
2904,rigid,10517,15884,15898,5367,14,5381,completed
2905,rigid,10517,15884,15924,5367,40,5407,completed
2906,rigid,10517,15884,15895,5367,11,5378,completed
2907,rigid,10517,15884,15902,5367,18,5385,completed
2908,rigid,10519,15884,15889,5365,5,5370,completed
2909,rigid,10519,15884,15889,5365,5,5370,completed
2910,rigid,10519,15885,15890,5366,5,5371,completed
2911,rigid,10519,15885,15889,5366,4,5370,completed
2912,rigid,10519,15885,15890,5366,5,5371,completed
2913,rigid,10519,15885,15890,5366,5,5371,completed
2914,rigid,10519,15889,15893,5370,4,5374,completed
2915,rigid,10519,15889,15894,5370,5,5375,completed
2916,rigid,10519,15889,15894,5370,5,5375,completed
2917,rigid,10519,15890,15895,5371,5,5376,completed
2918,rigid,10519,15890,15895,5371,5,5376,completed
2919,rigid,10519,15890,15894,5371,4,5375,completed
2920,rigid,10519,15891,15896,5372,5,5377,completed
2921,rigid,10519,15891,15895,5372,4,5376,completed
2922,rigid,10519,15891,15895,5372,4,5376,completed
2923,rigid,10519,15891,15896,5372,5,5377,completed
2924,rigid,10519,15893,15898,5374,5,5379,completed
2925,rigid,10519,15893,15897,5374,4,5378,completed
2926,rigid,10519,15893,15897,5374,4,5378,completed
2927,rigid,10519,15893,15898,5374,5,5379,completed
2928,rigid,10519,15893,15898,5374,5,5379,completed
2929,rigid,10519,15894,15898,5375,4,5379,completed
2930,rigid,10519,15894,15898,5375,4,5379,completed
2931,rigid,10519,15894,15899,5375,5,5380,completed
2932,rigid,10519,15894,15899,5375,5,5380,completed
2933,rigid,10519,15894,15899,5375,5,5380,completed
2934,rigid,10519,15894,15899,5375,5,5380,completed
2935,rigid,10519,15894,15899,5375,5,5380,completed
2936,rigid,10519,15895,15900,5376,5,5381,completed
2937,rigid,10519,15895,15899,5376,4,5380,completed
2938,rigid,10519,15895,15900,5376,5,5381,completed
2939,rigid,10519,15895,15899,5376,4,5380,completed
2940,rigid,10519,15895,15900,5376,5,5381,completed
2941,rigid,10519,15895,15900,5376,5,5381,completed
2942,rigid,10519,15895,15900,5376,5,5381,completed
2943,rigid,10519,15895,15900,5376,5,5381,completed
2944,rigid,10519,15895,15897,5376,2,5378,completed
2945,rigid,10526,15895,15897,5369,2,5371,completed
2946,rigid,10526,15895,15939,5369,44,5413,completed
2947,rigid,10526,15895,15907,5369,12,5381,completed
2948,rigid,10526,15895,15916,5369,21,5390,completed
2949,rigid,10526,15895,15911,5369,16,5385,completed
2950,rigid,10527,15895,15930,5368,35,5403,completed
2951,rigid,10530,15895,15897,5365,2,5367,completed
2952,rigid,10532,15897,18796,5365,2899,8264,completed
2953,rigid,10536,15897,15899,5361,2,5363,completed
2954,rigid,10548,15897,15899,5349,2,5351,completed
2955,rigid,10548,15897,15960,5349,63,5412,completed
2956,rigid,10548,15898,15923,5350,25,5375,completed
2957,rigid,10563,15898,15900,5335,2,5337,completed
2958,rigid,10563,15898,15921,5335,23,5358,completed
2959,rigid,10563,15898,15953,5335,55,5390,completed
2960,rigid,10563,15898,15913,5335,15,5350,completed
2961,rigid,10563,15898,15924,5335,26,5361,completed
2962,rigid,10579,15898,15948,5319,50,5369,completed
2963,rigid,10589,15898,15901,5309,3,5312,completed
2964,rigid,10589,15898,15947,5309,49,5358,completed
2965,rigid,10590,15898,16401,5308,503,5811,completed
2966,rigid,10590,15899,16402,5309,503,5812,completed
2967,rigid,10590,15900,16406,5310,506,5816,completed
2968,rigid,10590,15900,16416,5310,516,5826,completed
2969,rigid,10590,15912,16420,5322,508,5830,completed
2970,rigid,10590,15914,16426,5324,512,5836,completed
2971,rigid,10590,15927,16441,5337,514,5851,completed
2972,rigid,10590,15934,16453,5344,519,5863,completed
2973,rigid,10590,15939,16454,5349,515,5864,completed
2974,rigid,10590,15942,16459,5352,517,5869,completed
2975,rigid,10590,15944,16463,5354,519,5873,completed
2976,rigid,10599,15948,18975,5349,3027,8376,completed
2977,rigid,10603,15949,18776,5346,2827,8173,completed
2978,rigid,10605,15950,15958,5345,8,5353,completed
2979,rigid,10630,15950,15955,5320,5,5325,completed
2980,rigid,10630,15950,15988,5320,38,5358,completed
2981,rigid,10633,15955,17683,5322,1728,7050,completed
2982,rigid,10635,15955,17683,5320,1728,7048,completed
2983,rigid,10636,15955,17667,5319,1712,7031,completed
2984,rigid,10639,15958,15994,5319,36,5355,completed
2985,rigid,10642,15960,15972,5318,12,5330,completed
2986,rigid,10642,15975,16000,5333,25,5358,completed
2987,rigid,10655,15978,15983,5323,5,5328,completed
2988,rigid,10667,15978,15996,5311,18,5329,completed
2989,rigid,10669,15978,15987,5309,9,5318,completed
2990,rigid,10669,15978,15987,5309,9,5318,completed
2991,rigid,10669,15978,15981,5309,3,5312,completed
2992,rigid,10669,15978,16014,5309,36,5345,completed
2993,rigid,10669,15978,16043,5309,65,5374,completed
2994,rigid,10676,15978,15985,5302,7,5309,completed
2995,rigid,10676,15978,15981,5302,3,5305,completed
2996,rigid,10676,15978,16015,5302,37,5339,completed
2997,rigid,10676,15978,16042,5302,64,5366,completed
2998,rigid,10676,15978,15988,5302,10,5312,completed
2999,rigid,10705,15978,15979,5273,1,5274,completed
3000,rigid,10713,15978,15979,5265,1,5266,completed
3001,rigid,10733,15982,16012,5249,30,5279,completed
3002,rigid,11014,15982,15990,4968,8,4976,completed
3003,rigid,11014,15982,15989,4968,7,4975,completed
3004,rigid,11014,15982,16002,4968,20,4988,completed
3005,rigid,11014,15982,16000,4968,18,4986,completed
3006,rigid,11024,15982,15983,4958,1,4959,completed
3007,rigid,11026,15982,16002,4956,20,4976,completed
3008,rigid,11026,15983,16034,4957,51,5008,completed
3009,rigid,11026,15983,16018,4957,35,4992,completed
3010,rigid,11029,15983,17711,4954,1728,6682,completed
3011,rigid,11029,15985,17713,4956,1728,6684,completed
3012,rigid,11029,15989,17717,4960,1728,6688,completed
3013,rigid,11030,15992,17720,4962,1728,6690,completed
3014,rigid,11030,15992,17720,4962,1728,6690,completed
3015,rigid,11030,15992,17539,4962,1547,6509,completed
3016,rigid,11041,15996,16073,4955,77,5032,completed
3017,rigid,11041,15996,16073,4955,77,5032,completed
3018,rigid,11041,15999,16066,4958,67,5025,completed
3019,rigid,11041,15999,16047,4958,48,5006,completed
3020,rigid,11041,16000,16120,4959,120,5079,completed
3021,rigid,11041,16000,16062,4959,62,5021,completed
3022,rigid,11041,16001,16145,4960,144,5104,completed
3023,rigid,11041,16001,16035,4960,34,4994,completed
3024,rigid,11041,16002,16148,4961,146,5107,completed
3025,rigid,11041,16004,16037,4963,33,4996,completed
3026,rigid,11041,16004,16096,4963,92,5055,completed
3027,rigid,11041,16012,16157,4971,145,5116,completed
3028,rigid,11041,16020,16121,4979,101,5080,completed
3029,rigid,11041,16020,16061,4979,41,5020,completed
3030,rigid,11041,16030,16061,4989,31,5020,completed
3031,rigid,11041,16034,16100,4993,66,5059,completed
3032,rigid,11041,16034,16134,4993,100,5093,completed
3033,rigid,11041,16035,16083,4994,48,5042,completed
3034,rigid,11041,16037,16066,4996,29,5025,completed
3035,rigid,11042,16038,16074,4996,36,5032,completed
3036,rigid,11042,16038,16073,4996,35,5031,completed
3037,rigid,11042,16039,16066,4997,27,5024,completed
3038,rigid,11042,16047,16106,5005,59,5064,completed
3039,rigid,11042,16052,16130,5010,78,5088,completed
3040,rigid,11042,16052,16207,5010,155,5165,completed
3041,rigid,11042,16052,16090,5010,38,5048,completed
3042,rigid,11042,16055,16223,5013,168,5181,completed
3043,rigid,11042,16055,16176,5013,121,5134,completed
3044,rigid,11042,16055,16126,5013,71,5084,completed
3045,rigid,11042,16061,16093,5019,32,5051,completed
3046,rigid,11042,16061,16172,5019,111,5130,completed
3047,rigid,11042,16062,16201,5020,139,5159,completed
3048,rigid,11042,16066,16232,5024,166,5190,completed
3049,rigid,11042,16066,16100,5024,34,5058,completed
3050,rigid,11042,16066,16172,5024,106,5130,completed
3051,rigid,11042,16067,16177,5025,110,5135,completed
3052,rigid,11050,16067,16499,5017,432,5449,completed
3053,rigid,11050,16067,16499,5017,432,5449,completed
3054,rigid,11050,16073,16093,5023,20,5043,completed
3055,rigid,11053,16073,16999,5020,926,5946,completed
3056,rigid,11053,16073,17332,5020,1259,6279,completed
3057,rigid,11053,16073,16586,5020,513,5533,completed
3058,rigid,11067,16073,16074,5006,1,5007,completed
3059,rigid,11067,16073,16074,5006,1,5007,completed
3060,rigid,11067,16073,16082,5006,9,5015,completed
3061,rigid,11067,16073,16100,5006,27,5033,completed
3062,rigid,11067,16073,16086,5006,13,5019,completed
3063,rigid,11068,16074,16075,5006,1,5007,completed
3064,rigid,11069,16093,16129,5024,36,5060,completed
3065,rigid,11076,16093,16206,5017,113,5130,completed
3066,rigid,11078,16093,16117,5015,24,5039,completed
3067,rigid,11078,16093,16094,5015,1,5016,completed
3068,rigid,11081,16094,16095,5013,1,5014,completed
3069,rigid,11085,16095,16096,5010,1,5011,completed
3070,rigid,11085,16096,16099,5011,3,5014,completed
3071,rigid,11086,16096,16102,5010,6,5016,completed
3072,rigid,11087,16096,16099,5009,3,5012,completed
3073,rigid,11094,16099,16100,5005,1,5006,completed
3074,rigid,11094,16099,16103,5005,4,5009,completed
3075,rigid,11097,16100,16112,5003,12,5015,completed
3076,rigid,11101,16100,16130,4999,30,5029,completed
3077,rigid,11110,16100,16107,4990,7,4997,completed
3078,rigid,11111,16103,16372,4992,269,5261,completed
3079,rigid,11111,16103,16104,4992,1,4993,completed
3080,rigid,11112,16104,16105,4992,1,4993,completed
3081,rigid,11112,16104,16105,4992,1,4993,completed
3082,rigid,11112,16104,16105,4992,1,4993,completed
3083,rigid,11112,16104,16105,4992,1,4993,completed
3084,rigid,11112,16104,16105,4992,1,4993,completed
3085,rigid,11112,16104,16105,4992,1,4993,completed
3086,rigid,11112,16104,16105,4992,1,4993,completed
3087,rigid,11112,16104,16105,4992,1,4993,completed
3088,rigid,11112,16104,16106,4992,2,4994,completed
3089,rigid,11112,16104,16105,4992,1,4993,completed
3090,rigid,11112,16104,16105,4992,1,4993,completed
3091,rigid,11112,16104,16105,4992,1,4993,completed
3092,rigid,11112,16104,16105,4992,1,4993,completed
3093,rigid,11112,16105,16107,4993,2,4995,completed
3094,rigid,11112,16105,16106,4993,1,4994,completed
3095,rigid,11112,16105,16106,4993,1,4994,completed
3096,rigid,11112,16105,16106,4993,1,4994,completed
3097,rigid,11112,16105,16106,4993,1,4994,completed
3098,rigid,11112,16105,16106,4993,1,4994,completed
3099,rigid,11113,16105,16106,4992,1,4993,completed
3100,rigid,11113,16105,16106,4992,1,4993,completed
3101,rigid,11113,16105,16106,4992,1,4993,completed
3102,rigid,11114,16105,16106,4991,1,4992,completed
3103,rigid,11114,16105,16106,4991,1,4992,completed
3104,rigid,11114,16105,16106,4991,1,4992,completed
3105,rigid,11118,16105,16117,4987,12,4999,completed
3106,rigid,11135,16105,16117,4970,12,4982,completed
3107,rigid,11138,16105,16106,4967,1,4968,completed
3108,rigid,11138,16105,16106,4967,1,4968,completed
3109,rigid,11138,16105,16169,4967,64,5031,completed
3110,rigid,11140,16105,16921,4965,816,5781,completed
3111,rigid,11140,16106,17301,4966,1195,6161,completed
3112,rigid,11140,16106,16458,4966,352,5318,completed
3113,rigid,11155,16106,16118,4951,12,4963,completed
3114,rigid,11159,16107,16131,4948,24,4972,completed
3115,rigid,11179,16115,16623,4936,508,5444,completed
3116,rigid,11179,16116,16622,4937,506,5443,completed
3117,rigid,11181,16129,17602,4948,1473,6421,completed
3118,rigid,11187,16129,19005,4942,2876,7818,completed
3119,rigid,11188,16129,18782,4941,2653,7594,completed
3120,rigid,11188,16129,18870,4941,2741,7682,completed
3121,rigid,11189,16129,16639,4940,510,5450,completed
3122,rigid,11189,16129,17521,4940,1392,6332,completed
3123,rigid,11190,16129,16130,4939,1,4940,completed
3124,rigid,11190,16129,16130,4939,1,4940,completed
3125,rigid,11190,16129,16130,4939,1,4940,completed
3126,rigid,11190,16129,16130,4939,1,4940,completed
3127,rigid,11190,16129,16130,4939,1,4940,completed
3128,rigid,11190,16129,16130,4939,1,4940,completed
3129,rigid,11190,16129,16130,4939,1,4940,completed
3130,rigid,11192,16129,19289,4937,3160,8097,completed
3131,rigid,11192,16129,19100,4937,2971,7908,completed
3132,rigid,11192,16129,19114,4937,2985,7922,completed
3133,rigid,11192,16129,18879,4937,2750,7687,completed
3134,rigid,11192,16129,18730,4937,2601,7538,completed
3135,rigid,11192,16129,18852,4937,2723,7660,completed
3136,rigid,11193,16129,18833,4936,2704,7640,completed
3137,rigid,11193,16129,18953,4936,2824,7760,completed
3138,rigid,11193,16129,18946,4936,2817,7753,completed
3139,rigid,11193,16129,18825,4936,2696,7632,completed
3140,rigid,11193,16129,18669,4936,2540,7476,completed
3141,rigid,11193,16129,18759,4936,2630,7566,completed
3142,rigid,11194,16129,18083,4935,1954,6889,completed
3143,rigid,11194,16129,17980,4935,1851,6786,completed
3144,rigid,11194,16129,18660,4935,2531,7466,completed
3145,rigid,11194,16129,18753,4935,2624,7559,completed
3146,rigid,11194,16129,18598,4935,2469,7404,completed
3147,rigid,11194,16129,18504,4935,2375,7310,completed
3148,rigid,11195,16129,18880,4934,2751,7685,completed
3149,rigid,11195,16129,18715,4934,2586,7520,completed
3150,rigid,11195,16129,18849,4934,2720,7654,completed
3151,rigid,11195,16129,18412,4934,2283,7217,completed
3152,rigid,11195,16129,18570,4934,2441,7375,completed
3153,rigid,11195,16129,18570,4934,2441,7375,completed
3154,rigid,11195,16129,18600,4934,2471,7405,completed
3155,rigid,11195,16129,18637,4934,2508,7442,completed
3156,rigid,11195,16129,18459,4934,2330,7264,completed
3157,rigid,11196,16129,18320,4933,2191,7124,completed
3158,rigid,11196,16129,18709,4933,2580,7513,completed
3159,rigid,11196,16129,18665,4933,2536,7469,completed
3160,rigid,11196,16129,18140,4933,2011,6944,completed
3161,rigid,11196,16129,18733,4933,2604,7537,completed
3162,rigid,11196,16129,17923,4933,1794,6727,completed
3163,rigid,11196,16129,16988,4933,859,5792,completed
3164,rigid,11196,16129,16954,4933,825,5758,completed
3165,rigid,11196,16129,17120,4933,991,5924,completed
3166,rigid,11197,16129,18379,4932,2250,7182,completed
3167,rigid,11197,16129,18459,4932,2330,7262,completed
3168,rigid,11197,16129,18765,4932,2636,7568,completed
3169,rigid,11197,16129,18458,4932,2329,7261,completed
3170,rigid,11197,16129,16151,4932,22,4954,completed
3171,rigid,11198,16129,17349,4931,1220,6151,completed
3172,rigid,11198,16129,17259,4931,1130,6061,completed
3173,rigid,11198,16129,17358,4931,1229,6160,completed
3174,rigid,11198,16129,17305,4931,1176,6107,completed
3175,rigid,11198,16129,17336,4931,1207,6138,completed
3176,rigid,11203,16129,16209,4926,80,5006,completed
3177,rigid,11204,16129,16639,4925,510,5435,completed
3178,rigid,11205,16131,16239,4926,108,5034,completed
3179,rigid,11218,16135,16646,4917,511,5428,completed
3180,rigid,11220,16145,16241,4925,96,5021,completed
3181,rigid,11222,16149,16664,4927,515,5442,completed
3182,rigid,11234,16149,16221,4915,72,4987,completed
3183,rigid,11238,16149,16197,4911,48,4959,completed
3184,rigid,11242,16172,16685,4930,513,5443,completed
3185,rigid,11245,16172,16185,4927,13,4940,completed
3186,rigid,11245,16175,16913,4930,738,5668,completed
3187,rigid,11249,16175,16176,4926,1,4927,completed
3188,rigid,11252,16175,16326,4923,151,5074,completed
3189,rigid,11263,16175,16507,4912,332,5244,completed
3190,rigid,11282,16175,16860,4893,685,5578,completed
3191,rigid,11282,16176,16977,4894,801,5695,completed
3192,rigid,11282,16176,17346,4894,1170,6064,completed
3193,rigid,11282,16181,16696,4899,515,5414,completed
3194,rigid,11283,16181,17180,4898,999,5897,completed
3195,rigid,11283,16181,17541,4898,1360,6258,completed
3196,rigid,11283,16184,17046,4901,862,5763,completed
3197,rigid,11284,16184,16233,4900,49,4949,completed
3198,rigid,11284,16201,16717,4917,516,5433,completed
3199,rigid,11297,16204,16725,4907,521,5428,completed
3200,rigid,11313,16204,16232,4891,28,4919,completed
3201,rigid,11319,16206,16728,4887,522,5409,completed
3202,rigid,11324,16206,17070,4882,864,5746,completed
3203,rigid,11326,16217,16231,4891,14,4905,completed
3204,rigid,11333,16217,16254,4884,37,4921,completed
3205,rigid,11339,16217,17945,4878,1728,6606,completed
3206,rigid,11343,16217,16649,4874,432,5306,completed
3207,rigid,11371,16217,16223,4846,6,4852,completed
3208,rigid,11371,16217,16220,4846,3,4849,completed
3209,rigid,11371,16217,16225,4846,8,4854,completed
3210,rigid,11371,16217,16281,4846,64,4910,completed
3211,rigid,11371,16217,16253,4846,36,4882,completed
3212,rigid,11407,16217,16218,4810,1,4811,completed
3213,rigid,11445,16221,17947,4776,1726,6502,completed
3214,rigid,11445,16221,17732,4776,1511,6287,completed
3215,rigid,11538,16231,16870,4693,639,5332,completed
3216,rigid,11554,16231,16669,4677,438,5115,completed
3217,rigid,11555,16237,16937,4682,700,5382,completed
3218,rigid,11636,16239,19224,4603,2985,7588,completed
3219,rigid,11751,16239,16252,4488,13,4501,completed
3220,rigid,11761,16239,16863,4478,624,5102,completed
3221,rigid,11793,16239,16747,4446,508,4954,completed
3222,rigid,11795,16243,16753,4448,510,4958,completed
3223,rigid,11807,16256,16764,4449,508,4957,completed
3224,rigid,11820,16264,16779,4444,515,4959,completed
3225,rigid,11822,16275,16787,4453,512,4965,completed
3226,rigid,11826,16292,16806,4466,514,4980,completed
3227,rigid,11837,16295,16807,4458,512,4970,completed
3228,rigid,11839,16309,17182,4470,873,5343,completed
3229,rigid,11846,16311,16830,4465,519,4984,completed
3230,rigid,11854,16319,16837,4465,518,4983,completed
3231,rigid,11859,16368,16895,4509,527,5036,completed
3232,rigid,11866,16370,16892,4504,522,5026,completed
3233,rigid,11876,16372,17631,4496,1259,5755,completed
3234,rigid,11876,16372,16547,4496,175,4671,completed
3235,rigid,11876,16372,16522,4496,150,4646,completed
3236,rigid,11876,16372,16787,4496,415,4911,completed
3237,rigid,11876,16401,17411,4525,1010,5535,completed
3238,rigid,11876,16401,16674,4525,273,4798,completed
3239,rigid,11877,16401,17577,4524,1176,5700,completed
3240,rigid,11877,16401,17780,4524,1379,5903,completed
3241,rigid,11877,16402,17975,4525,1573,6098,completed
3242,rigid,11877,16402,17809,4525,1407,5932,completed
3243,rigid,11877,16402,17075,4525,673,5198,completed
3244,rigid,11877,16402,17655,4525,1253,5778,completed
3245,rigid,11878,16406,17886,4528,1480,6008,completed
3246,rigid,11878,16406,17073,4528,667,5195,completed
3247,rigid,11878,16406,17194,4528,788,5316,completed
3248,rigid,11878,16406,16534,4528,128,4656,completed
3249,rigid,11885,16406,16407,4521,1,4522,completed
3250,rigid,11885,16406,16407,4521,1,4522,completed
3251,rigid,11885,16406,16407,4521,1,4522,completed
3252,rigid,11885,16406,16407,4521,1,4522,completed
3253,rigid,11885,16406,16454,4521,48,4569,completed
3254,rigid,11885,16406,16458,4521,52,4573,completed
3255,rigid,11885,16416,18053,4531,1637,6168,completed
3256,rigid,11885,16416,17658,4531,1242,5773,completed
3257,rigid,11885,16416,17377,4531,961,5492,completed
3258,rigid,11886,16416,17523,4530,1107,5637,completed
3259,rigid,11886,16420,17593,4534,1173,5707,completed
3260,rigid,11886,16420,17807,4534,1387,5921,completed
3261,rigid,11886,16420,17130,4534,710,5244,completed
3262,rigid,11886,16420,17019,4534,599,5133,completed
3263,rigid,11886,16426,17218,4540,792,5332,completed
3264,rigid,11886,16426,16974,4540,548,5088,completed
3265,rigid,11886,16426,17804,4540,1378,5918,completed
3266,rigid,11886,16426,17932,4540,1506,6046,completed
3267,rigid,11888,16453,19909,4565,3456,8021,completed
3268,rigid,11889,16453,16483,4564,30,4594,completed
3269,rigid,11895,16453,16502,4558,49,4607,completed
3270,rigid,11904,16454,16457,4550,3,4553,completed
3271,rigid,11907,16454,16467,4547,13,4560,completed
3272,rigid,11913,16457,17085,4544,628,5172,completed
3273,rigid,11920,16458,16491,4538,33,4571,completed
3274,rigid,11923,16459,16471,4536,12,4548,completed
3275,rigid,11928,16459,16472,4531,13,4544,completed
3276,rigid,11934,16459,16787,4525,328,4853,completed
3277,rigid,11938,16459,16818,4521,359,4880,completed
3278,rigid,11939,16459,16472,4520,13,4533,completed
3279,rigid,11939,16463,16467,4524,4,4528,completed
3280,rigid,11939,16463,16474,4524,11,4535,completed
3281,rigid,11939,16463,16466,4524,3,4527,completed
3282,rigid,11939,16463,16469,4524,6,4530,completed
3283,rigid,11939,16466,16472,4527,6,4533,completed
3284,rigid,11939,16467,16472,4528,5,4533,completed
3285,rigid,11947,16471,16476,4524,5,4529,completed
3286,rigid,11954,16471,16478,4517,7,4524,completed
3287,rigid,11954,16472,16479,4518,7,4525,completed
3288,rigid,11954,16472,16475,4518,3,4521,completed
3289,rigid,11954,16472,16475,4518,3,4521,completed
3290,rigid,11954,16472,16475,4518,3,4521,completed
3291,rigid,11954,16474,16477,4520,3,4523,completed
3292,rigid,11959,16475,16522,4516,47,4563,completed
3293,rigid,11963,16475,16485,4512,10,4522,completed
3294,rigid,11967,16476,16829,4509,353,4862,completed
3295,rigid,11967,16479,17303,4512,824,5336,completed
3296,rigid,11973,16483,16498,4510,15,4525,completed
3297,rigid,11974,16485,16496,4511,11,4522,completed
3298,rigid,11986,16488,16490,4502,2,4504,completed
3299,rigid,11989,16488,16489,4499,1,4500,completed
3300,rigid,11990,16488,16631,4498,143,4641,completed
3301,rigid,11990,16488,16628,4498,140,4638,completed
3302,rigid,11990,16489,16629,4499,140,4639,completed
3303,rigid,11990,16490,16629,4500,139,4639,completed
3304,rigid,11990,16491,16520,4501,29,4530,completed
3305,rigid,11990,16496,16523,4506,27,4533,completed
3306,rigid,11990,16498,16636,4508,138,4646,completed
3307,rigid,11990,16499,16639,4509,140,4649,completed
3308,rigid,11990,16499,16640,4509,141,4650,completed
3309,rigid,11990,16499,16638,4509,139,4648,completed
3310,rigid,11990,16499,16639,4509,140,4649,completed
3311,rigid,11990,16502,16640,4512,138,4650,completed
3312,rigid,11990,16507,16646,4517,139,4656,completed
3313,rigid,11990,16507,16647,4517,140,4657,completed
3314,rigid,11990,16520,16659,4530,139,4669,completed
3315,rigid,11990,16522,16663,4532,141,4673,completed
3316,rigid,11990,16522,16527,4532,5,4537,completed
3317,rigid,11992,16523,16525,4531,2,4533,completed
3318,rigid,11992,16525,16526,4533,1,4534,completed
3319,rigid,11992,16526,16527,4534,1,4535,completed
3320,rigid,11992,16527,16528,4535,1,4536,completed
3321,rigid,11992,16527,16529,4535,2,4537,completed
3322,rigid,11997,16528,16531,4531,3,4534,completed
3323,rigid,12008,16528,16572,4520,44,4564,completed
3324,rigid,12012,16529,16536,4517,7,4524,completed
3325,rigid,12015,16547,16554,4532,7,4539,completed
3326,rigid,12019,16547,19780,4528,3233,7761,completed
3327,rigid,12020,16554,16565,4534,11,4545,completed
3328,rigid,12020,16572,17069,4552,497,5049,completed
3329,rigid,12021,16572,19516,4551,2944,7495,completed
3330,rigid,12021,16572,19643,4551,3071,7622,completed
3331,rigid,12021,16572,19486,4551,2914,7465,completed
3332,rigid,12021,16572,19596,4551,3024,7575,completed
3333,rigid,12024,16572,16609,4548,37,4585,completed
3334,rigid,12024,16586,16646,4562,60,4622,completed
3335,rigid,12024,16609,16676,4585,67,4652,completed
3336,rigid,12024,16622,16740,4598,118,4716,completed
3337,rigid,12024,16622,16698,4598,76,4674,completed
3338,rigid,12024,16622,16716,4598,94,4692,completed
3339,rigid,12024,16622,16697,4598,75,4673,completed
3340,rigid,12024,16623,16666,4599,43,4642,completed
3341,rigid,12024,16623,16714,4599,91,4690,completed
3342,rigid,12024,16623,16688,4599,65,4664,completed
3343,rigid,12024,16623,16697,4599,74,4673,completed
3344,rigid,12024,16628,16644,4604,16,4620,completed
3345,rigid,12024,16629,16652,4605,23,4628,completed
3346,rigid,12027,16638,17401,4611,763,5374,completed
3347,rigid,12032,16639,16650,4607,11,4618,completed
3348,rigid,12032,16640,17071,4608,431,5039,completed
3349,rigid,12040,16640,16820,4600,180,4780,completed
3350,rigid,12040,16644,16744,4604,100,4704,completed
3351,rigid,12041,16646,16694,4605,48,4653,completed
3352,rigid,12042,16646,16652,4604,6,4610,completed
3353,rigid,12050,16646,16682,4596,36,4632,completed
3354,rigid,12058,16646,16656,4588,10,4598,completed
3355,rigid,12063,16646,16655,4583,9,4592,completed
3356,rigid,12063,16647,16814,4584,167,4751,completed
3357,rigid,12064,16649,16685,4585,36,4621,completed
3358,rigid,12081,16655,16662,4574,7,4581,completed
3359,rigid,12087,16656,16668,4569,12,4581,completed
3360,rigid,12088,16659,16671,4571,12,4583,completed
3361,rigid,12092,16662,16664,4570,2,4572,completed
3362,rigid,12096,16664,16665,4568,1,4569,completed
3363,rigid,12098,16664,16665,4566,1,4567,completed
3364,rigid,12103,16665,16669,4562,4,4566,completed
3365,rigid,12125,16665,16701,4540,36,4576,completed
3366,rigid,12125,16665,16666,4540,1,4541,completed
3367,rigid,12131,16666,16675,4535,9,4544,completed
3368,rigid,12131,16666,16707,4535,41,4576,completed
3369,rigid,12133,16669,16694,4536,25,4561,completed
3370,rigid,12142,16669,16691,4527,22,4549,completed
3371,rigid,12142,16669,16712,4527,43,4570,completed
3372,rigid,12142,16669,16851,4527,182,4709,completed
3373,rigid,12142,16669,16709,4527,40,4567,completed
3374,rigid,12142,16671,16814,4529,143,4672,completed
3375,rigid,12142,16671,16843,4529,172,4701,completed
3376,rigid,12142,16671,16891,4529,220,4749,completed
3377,rigid,12142,16671,16780,4529,109,4638,completed
3378,rigid,12142,16671,16810,4529,139,4668,completed
3379,rigid,12142,16671,16766,4529,95,4624,completed
3380,rigid,12142,16674,16749,4532,75,4607,completed
3381,rigid,12147,16675,18009,4528,1334,5862,completed
3382,rigid,12147,16675,17907,4528,1232,5760,completed
3383,rigid,12147,16675,17927,4528,1252,5780,completed
3384,rigid,12153,16685,16688,4532,3,4535,completed
3385,rigid,12157,16685,16686,4528,1,4529,completed
3386,rigid,12159,16686,16689,4527,3,4530,completed
3387,rigid,12161,16688,16697,4527,9,4536,completed
3388,rigid,12164,16688,16712,4524,24,4548,completed
3389,rigid,12167,16689,20289,4522,3600,8122,completed
3390,rigid,12169,16691,16694,4522,3,4525,completed
3391,rigid,12186,16694,19359,4508,2665,7173,completed
3392,rigid,12192,16694,16730,4502,36,4538,completed
3393,rigid,12207,16696,16790,4489,94,4583,completed
3394,rigid,12207,16696,16809,4489,113,4602,completed
3395,rigid,12207,16696,17121,4489,425,4914,completed
3396,rigid,12207,16696,16846,4489,150,4639,completed
3397,rigid,12207,16696,16794,4489,98,4587,completed
3398,rigid,12228,16697,18136,4469,1439,5908,completed
3399,rigid,12238,16709,18140,4471,1431,5902,completed
3400,rigid,12262,16709,16751,4447,42,4489,completed
3401,rigid,12297,16709,16749,4412,40,4452,completed
3402,rigid,12301,16712,17224,4411,512,4923,completed
3403,rigid,12302,16717,16738,4415,21,4436,completed
3404,rigid,12304,16717,16748,4413,31,4444,completed
3405,rigid,12306,16725,17234,4419,509,4928,completed
3406,rigid,12316,16728,17238,4412,510,4922,completed
3407,rigid,12327,16728,18456,4401,1728,6129,completed
3408,rigid,12335,16730,17245,4395,515,4910,completed
3409,rigid,12336,16730,16733,4394,3,4397,completed
3410,rigid,12336,16730,16736,4394,6,4400,completed
3411,rigid,12336,16730,16780,4394,50,4444,completed
3412,rigid,12336,16730,16735,4394,5,4399,completed
3413,rigid,12336,16730,16761,4394,31,4425,completed
3414,rigid,12336,16738,17249,4402,511,4913,completed
3415,rigid,12338,16738,16776,4400,38,4438,completed
3416,rigid,12341,16744,17263,4403,519,4922,completed
3417,rigid,12348,16747,18069,4399,1322,5721,completed
3418,rigid,12349,16748,16769,4399,21,4420,completed
3419,rigid,12349,16753,16774,4404,21,4425,completed
3420,rigid,12349,16764,16785,4415,21,4436,completed
3421,rigid,12349,16769,16790,4420,21,4441,completed
3422,rigid,12349,16774,16795,4425,21,4446,completed
3423,rigid,12349,16779,16800,4430,21,4451,completed
3424,rigid,12349,16785,16806,4436,21,4457,completed
3425,rigid,12349,16785,16806,4436,21,4457,completed
3426,rigid,12349,16787,16808,4438,21,4459,completed
3427,rigid,12349,16790,16811,4441,21,4462,completed
3428,rigid,12349,16795,16816,4446,21,4467,completed
3429,rigid,12349,16800,16821,4451,21,4472,completed
3430,rigid,12349,16806,16827,4457,21,4478,completed
3431,rigid,12349,16806,16827,4457,21,4478,completed
3432,rigid,12349,16806,16827,4457,21,4478,completed
3433,rigid,12349,16807,16828,4458,21,4479,completed
3434,rigid,12350,16808,17324,4458,516,4974,completed
3435,rigid,12365,16809,17327,4444,518,4962,completed
3436,rigid,12373,16811,17331,4438,520,4958,completed
3437,rigid,12376,16811,16862,4435,51,4486,completed
3438,rigid,12376,16811,16816,4435,5,4440,completed
3439,rigid,12376,16811,16814,4435,3,4438,completed
3440,rigid,12376,16811,16817,4435,6,4441,completed
3441,rigid,12376,16811,16843,4435,32,4467,completed
3442,rigid,12387,16816,17342,4429,526,4955,completed
3443,rigid,12388,16820,17348,4432,528,4960,completed
3444,rigid,12542,16821,18687,4279,1866,6145,completed
3445,rigid,12542,16827,18129,4285,1302,5587,completed
3446,rigid,12542,16827,18928,4285,2101,6386,completed
3447,rigid,12542,16827,17337,4285,510,4795,completed
3448,rigid,12608,16828,17465,4220,637,4857,completed
3449,rigid,12634,16828,16853,4194,25,4219,completed
3450,rigid,12634,16828,16853,4194,25,4219,completed
3451,rigid,12634,16828,16853,4194,25,4219,completed
3452,rigid,12634,16828,16853,4194,25,4219,completed
3453,rigid,12649,16829,17020,4180,191,4371,completed
3454,rigid,12673,16830,17186,4157,356,4513,completed
3455,rigid,12673,16837,17444,4164,607,4771,completed
3456,rigid,12749,16837,16838,4088,1,4089,completed
3457,rigid,12751,16838,16844,4087,6,4093,completed
3458,rigid,12755,16838,16872,4083,34,4117,completed
3459,rigid,12755,16843,16894,4088,51,4139,completed
3460,rigid,12755,16844,16897,4089,53,4142,completed
3461,rigid,12755,16844,16933,4089,89,4178,completed
3462,rigid,12755,16846,16905,4091,59,4150,completed
3463,rigid,12755,16851,16954,4096,103,4199,completed
3464,rigid,12755,16860,16894,4105,34,4139,completed
3465,rigid,12755,16863,16918,4108,55,4163,completed
3466,rigid,12755,16863,16911,4108,48,4156,completed
3467,rigid,12755,16863,16887,4108,24,4132,completed
3468,rigid,12755,16863,16886,4108,23,4131,completed
3469,rigid,12755,16864,16900,4109,36,4145,completed
3470,rigid,12755,16864,16897,4109,33,4142,completed
3471,rigid,12755,16870,16875,4115,5,4120,completed
3472,rigid,12755,16870,16897,4115,27,4142,completed
3473,rigid,12756,16875,17474,4119,599,4718,completed
3474,rigid,12756,16876,17206,4120,330,4450,completed
3475,rigid,12764,16876,16882,4112,6,4118,completed
3476,rigid,12764,16876,16882,4112,6,4118,completed
3477,rigid,12764,16876,16883,4112,7,4119,completed
3478,rigid,12764,16876,16882,4112,6,4118,completed
3479,rigid,12764,16876,16884,4112,8,4120,completed
3480,rigid,12764,16876,16889,4112,13,4125,completed
3481,rigid,12764,16876,16889,4112,13,4125,completed
3482,rigid,12764,16876,16886,4112,10,4122,completed
3483,rigid,12764,16876,16888,4112,12,4124,completed
3484,rigid,12765,16886,16887,4121,1,4122,completed
3485,rigid,12766,16887,17779,4121,892,5013,completed
3486,rigid,12766,16887,17862,4121,975,5096,completed
3487,rigid,12766,16891,17712,4125,821,4946,completed
3488,rigid,12767,16892,17703,4125,811,4936,completed
3489,rigid,12767,16892,18179,4125,1287,5412,completed
3490,rigid,12767,16892,17593,4125,701,4826,completed
3491,rigid,12770,16892,18620,4122,1728,5850,completed
3492,rigid,12770,16894,18622,4124,1728,5852,completed
3493,rigid,12770,16894,18622,4124,1728,5852,completed
3494,rigid,12771,16895,18623,4124,1728,5852,completed
3495,rigid,12771,16895,18623,4124,1728,5852,completed
3496,rigid,12771,16895,18623,4124,1728,5852,completed
3497,rigid,12772,16895,16896,4123,1,4124,completed
3498,rigid,12772,16896,17760,4124,864,4988,completed
3499,rigid,12772,16897,17761,4125,864,4989,completed
3500,rigid,12773,16897,17761,4124,864,4988,completed
3501,rigid,12773,16897,17761,4124,864,4988,completed
3502,rigid,12774,16913,16934,4139,21,4160,completed
3503,rigid,12774,16913,16914,4139,1,4140,completed
3504,rigid,12774,16913,17777,4139,864,5003,completed
3505,rigid,12774,16913,17777,4139,864,5003,completed
3506,rigid,12777,16913,18641,4136,1728,5864,completed
3507,rigid,12777,16913,18641,4136,1728,5864,completed
3508,rigid,12777,16913,17110,4136,197,4333,completed
3509,rigid,12777,16913,16916,4136,3,4139,completed
3510,rigid,12777,16913,17107,4136,194,4330,completed
3511,rigid,12778,16914,17634,4136,720,4856,completed
3512,rigid,12778,16916,17636,4138,720,4858,completed
3513,rigid,12778,16916,17636,4138,720,4858,completed
3514,rigid,12779,16918,16919,4139,1,4140,completed
3515,rigid,12783,16919,16922,4136,3,4139,completed
3516,rigid,12783,16921,16924,4138,3,4141,completed
3517,rigid,12789,16922,16924,4133,2,4135,completed
3518,rigid,12790,16924,16956,4134,32,4166,completed
3519,rigid,12793,16924,16926,4131,2,4133,completed
3520,rigid,12796,16926,16928,4130,2,4132,completed
3521,rigid,12799,16928,16930,4129,2,4131,completed
3522,rigid,12801,16934,17006,4133,72,4205,completed
3523,rigid,12802,16934,17798,4132,864,4996,completed
3524,rigid,12802,16934,16938,4132,4,4136,completed
3525,rigid,12804,16937,18356,4133,1419,5552,completed
3526,rigid,12804,16956,18211,4152,1255,5407,completed
3527,rigid,12807,16956,16960,4149,4,4153,completed
3528,rigid,12808,16999,17131,4191,132,4323,completed
3529,rigid,12812,17006,17010,4194,4,4198,completed
3530,rigid,12813,17006,17013,4193,7,4200,completed
3531,rigid,12814,17013,17524,4199,511,4710,completed
3532,rigid,12815,17019,17328,4204,309,4513,completed
3533,rigid,12816,17069,17583,4253,514,4767,completed
3534,rigid,12816,17069,17073,4253,4,4257,completed
3535,rigid,12821,17069,17077,4248,8,4256,completed
3536,rigid,12825,17069,17749,4244,680,4924,completed
3537,rigid,12825,17070,17391,4245,321,4566,completed
3538,rigid,12826,17071,17600,4245,529,4774,completed
3539,rigid,12831,17071,17092,4240,21,4261,completed
3540,rigid,12831,17071,17086,4240,15,4255,completed
3541,rigid,12831,17071,17098,4240,27,4267,completed
3542,rigid,12831,17071,17094,4240,23,4263,completed
3543,rigid,12831,17071,17102,4240,31,4271,completed
3544,rigid,12838,17075,17637,4237,562,4799,completed
3545,rigid,12838,17085,17613,4247,528,4775,completed
3546,rigid,12838,17092,17498,4254,406,4660,completed
3547,rigid,12838,17107,17495,4269,388,4657,completed
3548,rigid,12838,17131,17530,4293,399,4692,completed
3549,rigid,12838,17180,17623,4342,443,4785,completed
3550,rigid,12838,17182,17759,4344,577,4921,completed
3551,rigid,12838,17186,17615,4348,429,4777,completed
3552,rigid,12838,17206,17641,4368,435,4803,completed
3553,rigid,12838,17224,17637,4386,413,4799,completed
3554,rigid,12838,17234,17759,4396,525,4921,completed
3555,rigid,12838,17238,17654,4400,416,4816,completed
3556,rigid,12838,17245,17812,4407,567,4974,completed
3557,rigid,12838,17249,17685,4411,436,4847,completed
3558,rigid,12838,17249,17647,4411,398,4809,completed
3559,rigid,12838,17251,17736,4413,485,4898,completed
3560,rigid,12838,17259,17705,4421,446,4867,completed
3561,rigid,12838,17263,17671,4425,408,4833,completed
3562,rigid,12838,17296,17683,4458,387,4845,completed
3563,rigid,12838,17303,17660,4465,357,4822,completed
3564,rigid,12838,17324,17700,4486,376,4862,completed
3565,rigid,12838,17327,17852,4489,525,5014,completed
3566,rigid,12838,17331,17898,4493,567,5060,completed
3567,rigid,12838,17332,17871,4494,539,5033,completed
3568,rigid,12838,17337,17820,4499,483,4982,completed
3569,rigid,12838,17342,17858,4504,516,5020,completed
3570,rigid,12838,17348,17925,4510,577,5087,completed
3571,rigid,12838,17387,17942,4549,555,5104,completed
3572,rigid,12838,17387,17901,4549,514,5063,completed
3573,rigid,12838,17391,17895,4553,504,5057,completed
3574,rigid,12838,17401,17878,4563,477,5040,completed
3575,rigid,12838,17419,17869,4581,450,5031,completed
3576,rigid,12838,17444,17999,4606,555,5161,completed
3577,rigid,12838,17465,18023,4627,558,5185,completed
3578,rigid,12838,17469,17912,4631,443,5074,completed
3579,rigid,12838,17474,18032,4636,558,5194,completed
3580,rigid,12838,17495,17921,4657,426,5083,completed
3581,rigid,12838,17498,17901,4660,403,5063,completed
3582,rigid,12838,17523,17992,4685,469,5154,completed
3583,rigid,12838,17524,18018,4686,494,5180,completed
3584,rigid,12844,17530,17540,4686,10,4696,completed
3585,rigid,12845,17541,18201,4696,660,5356,completed
3586,rigid,12845,17593,18242,4748,649,5397,completed
3587,rigid,12845,17602,18260,4757,658,5415,completed
3588,rigid,12845,17602,18245,4757,643,5400,completed
3589,rigid,12845,17602,18255,4757,653,5410,completed
3590,rigid,12845,17602,18259,4757,657,5414,completed
3591,rigid,12845,17613,18259,4768,646,5414,completed
3592,rigid,12845,17623,18270,4778,647,5425,completed
3593,rigid,12847,17634,18150,4787,516,5303,completed
3594,rigid,12851,17637,18153,4786,516,5302,completed
3595,rigid,12852,17637,17642,4785,5,4790,completed
3596,rigid,12853,17637,17697,4784,60,4844,completed
3597,rigid,12856,17637,17672,4781,35,4816,completed
3598,rigid,12859,17637,17642,4778,5,4783,completed
3599,rigid,12860,17641,18157,4781,516,5297,completed
3600,rigid,12862,17641,17802,4779,161,4940,completed
3601,rigid,12865,17642,17684,4777,42,4819,completed
3602,rigid,12865,17642,17684,4777,42,4819,completed
3603,rigid,12865,17647,17687,4782,40,4822,completed
3604,rigid,12865,17647,17687,4782,40,4822,completed
3605,rigid,12865,17647,17681,4782,34,4816,completed
3606,rigid,12865,17647,17667,4782,20,4802,completed
3607,rigid,12868,17654,17696,4786,42,4828,completed
3608,rigid,12868,17654,17667,4786,13,4799,completed
3609,rigid,12869,17654,17820,4785,166,4951,completed
3610,rigid,12905,17655,17684,4750,29,4779,completed
3611,rigid,12909,17660,18177,4751,517,5268,completed
3612,rigid,12911,17667,18190,4756,523,5279,completed
3613,rigid,12913,17669,18194,4756,525,5281,completed
3614,rigid,12916,17669,17765,4753,96,4849,completed
3615,rigid,12916,17669,17746,4753,77,4830,completed
3616,rigid,12916,17671,17744,4755,73,4828,completed
3617,rigid,12916,17671,17734,4755,63,4818,completed
3618,rigid,12916,17671,17777,4755,106,4861,completed
3619,rigid,12916,17671,17739,4755,68,4823,completed
3620,rigid,12916,17672,17739,4756,67,4823,completed
3621,rigid,12916,17672,17755,4756,83,4839,completed
3622,rigid,12916,17681,17775,4765,94,4859,completed
3623,rigid,12916,17683,17719,4767,36,4803,completed
3624,rigid,12916,17683,17726,4767,43,4810,completed
3625,rigid,12916,17683,17740,4767,57,4824,completed
3626,rigid,12916,17683,17729,4767,46,4813,completed
3627,rigid,12916,17683,17695,4767,12,4779,completed
3628,rigid,12916,17683,17739,4767,56,4823,completed
3629,rigid,12920,17683,17688,4763,5,4768,completed
3630,rigid,12920,17683,17688,4763,5,4768,completed
3631,rigid,12920,17683,17688,4763,5,4768,completed
3632,rigid,12920,17684,17689,4764,5,4769,completed
3633,rigid,12920,17684,17689,4764,5,4769,completed
3634,rigid,12920,17684,17689,4764,5,4769,completed
3635,rigid,12920,17684,17689,4764,5,4769,completed
3636,rigid,12920,17685,17690,4765,5,4770,completed
3637,rigid,12920,17685,17690,4765,5,4770,completed
3638,rigid,12920,17685,17690,4765,5,4770,completed
3639,rigid,12920,17685,17690,4765,5,4770,completed
3640,rigid,12920,17687,17692,4767,5,4772,completed
3641,rigid,12920,17687,17692,4767,5,4772,completed
3642,rigid,12920,17688,17693,4768,5,4773,completed
3643,rigid,12920,17688,17693,4768,5,4773,completed
3644,rigid,12920,17688,17693,4768,5,4773,completed
3645,rigid,12920,17689,18214,4769,525,5294,completed
3646,rigid,12931,17690,17845,4759,155,4914,completed
3647,rigid,12931,17690,17842,4759,152,4911,completed
3648,rigid,12932,17690,17748,4758,58,4816,completed
3649,rigid,12936,17690,17697,4754,7,4761,completed
3650,rigid,12938,17690,17734,4752,44,4796,completed
3651,rigid,12939,17691,18570,4752,879,5631,completed
3652,rigid,12939,17692,19420,4753,1728,6481,completed
3653,rigid,12939,17692,18628,4753,936,5689,completed
3654,rigid,12942,17693,17730,4751,37,4788,completed
3655,rigid,12948,17693,17701,4745,8,4753,completed
3656,rigid,12951,17695,17696,4744,1,4745,completed
3657,rigid,12956,17697,17721,4741,24,4765,completed
3658,rigid,12958,17699,17705,4741,6,4747,completed
3659,rigid,12958,17700,17706,4742,6,4748,completed
3660,rigid,12972,17700,17705,4728,5,4733,completed
3661,rigid,12974,17700,17702,4726,2,4728,completed
3662,rigid,12974,17701,17705,4727,4,4731,completed
3663,rigid,12981,17701,17710,4720,9,4729,completed
3664,rigid,12981,17701,17710,4720,9,4729,completed
3665,rigid,12981,17701,17710,4720,9,4729,completed
3666,rigid,12981,17701,17710,4720,9,4729,completed
3667,rigid,12981,17701,17710,4720,9,4729,completed
3668,rigid,12981,17701,17719,4720,18,4738,completed
3669,rigid,12981,17701,17711,4720,10,4730,completed
3670,rigid,12981,17701,17711,4720,10,4730,completed
3671,rigid,12981,17702,17712,4721,10,4731,completed
3672,rigid,12981,17703,17713,4722,10,4732,completed
3673,rigid,12981,17703,17712,4722,9,4731,completed
3674,rigid,12981,17703,17712,4722,9,4731,completed
3675,rigid,12981,17703,17712,4722,9,4731,completed
3676,rigid,12981,17703,17712,4722,9,4731,completed
3677,rigid,12981,17703,17712,4722,9,4731,completed
3678,rigid,12981,17703,17712,4722,9,4731,completed
3679,rigid,12981,17703,17712,4722,9,4731,completed
3680,rigid,12981,17703,17712,4722,9,4731,completed
3681,rigid,12981,17705,17714,4724,9,4733,completed
3682,rigid,12981,17705,17714,4724,9,4733,completed
3683,rigid,12981,17705,17723,4724,18,4742,completed
3684,rigid,12981,17705,17716,4724,11,4735,completed
3685,rigid,12981,17705,17723,4724,18,4742,completed
3686,rigid,12981,17705,17729,4724,24,4748,completed
3687,rigid,12981,17705,17716,4724,11,4735,completed
3688,rigid,12981,17705,17714,4724,9,4733,completed
3689,rigid,12981,17705,17714,4724,9,4733,completed
3690,rigid,12981,17705,17714,4724,9,4733,completed
3691,rigid,12981,17705,17714,4724,9,4733,completed
3692,rigid,12981,17705,17714,4724,9,4733,completed
3693,rigid,12981,17705,17723,4724,18,4742,completed
3694,rigid,12981,17705,17718,4724,13,4737,completed
3695,rigid,12981,17705,17718,4724,13,4737,completed
3696,rigid,12981,17705,17715,4724,10,4734,completed
3697,rigid,12981,17705,17714,4724,9,4733,completed
3698,rigid,12981,17705,17714,4724,9,4733,completed
3699,rigid,12981,17705,17714,4724,9,4733,completed
3700,rigid,12981,17705,17714,4724,9,4733,completed
3701,rigid,12981,17705,17714,4724,9,4733,completed
3702,rigid,12981,17705,17714,4724,9,4733,completed
3703,rigid,12981,17705,17714,4724,9,4733,completed
3704,rigid,12981,17705,17714,4724,9,4733,completed
3705,rigid,12981,17705,17714,4724,9,4733,completed
3706,rigid,12981,17705,17721,4724,16,4740,completed
3707,rigid,12981,17705,17726,4724,21,4745,completed
3708,rigid,12981,17705,17715,4724,10,4734,completed
3709,rigid,12981,17705,17726,4724,21,4745,completed
3710,rigid,12981,17705,17735,4724,30,4754,completed
3711,rigid,12981,17705,17715,4724,10,4734,completed
3712,rigid,12981,17705,17723,4724,18,4742,completed
3713,rigid,12981,17705,17715,4724,10,4734,completed
3714,rigid,12981,17705,17723,4724,18,4742,completed
3715,rigid,12981,17705,17723,4724,18,4742,completed
3716,rigid,12981,17705,17714,4724,9,4733,completed
3717,rigid,12981,17705,17714,4724,9,4733,completed
3718,rigid,12981,17705,17714,4724,9,4733,completed
3719,rigid,12981,17705,17714,4724,9,4733,completed
3720,rigid,12981,17705,17714,4724,9,4733,completed
3721,rigid,12981,17705,17714,4724,9,4733,completed
3722,rigid,12981,17705,17714,4724,9,4733,completed
3723,rigid,12981,17705,17714,4724,9,4733,completed
3724,rigid,12981,17705,17714,4724,9,4733,completed
3725,rigid,12981,17705,17714,4724,9,4733,completed
3726,rigid,12981,17705,17714,4724,9,4733,completed
3727,rigid,12981,17705,17714,4724,9,4733,completed
3728,rigid,12981,17705,17714,4724,9,4733,completed
3729,rigid,12981,17705,17714,4724,9,4733,completed
3730,rigid,12981,17705,17714,4724,9,4733,completed
3731,rigid,12981,17705,17715,4724,10,4734,completed
3732,rigid,12981,17705,17720,4724,15,4739,completed
3733,rigid,12981,17705,17722,4724,17,4741,completed
3734,rigid,12981,17705,17715,4724,10,4734,completed
3735,rigid,12981,17705,17722,4724,17,4741,completed
3736,rigid,12981,17705,17723,4724,18,4742,completed
3737,rigid,12981,17705,17714,4724,9,4733,completed
3738,rigid,12981,17705,17714,4724,9,4733,completed
3739,rigid,12981,17705,17714,4724,9,4733,completed
3740,rigid,12981,17705,17714,4724,9,4733,completed
3741,rigid,12981,17705,17714,4724,9,4733,completed
3742,rigid,12981,17705,17714,4724,9,4733,completed
3743,rigid,12981,17705,17714,4724,9,4733,completed
3744,rigid,12981,17705,17726,4724,21,4745,completed
3745,rigid,12981,17705,17723,4724,18,4742,completed
3746,rigid,12981,17705,17714,4724,9,4733,completed
3747,rigid,12981,17705,17714,4724,9,4733,completed
3748,rigid,12981,17705,17714,4724,9,4733,completed
3749,rigid,12981,17705,17714,4724,9,4733,completed
3750,rigid,12981,17705,17714,4724,9,4733,completed
3751,rigid,12981,17705,17714,4724,9,4733,completed
3752,rigid,12981,17705,17714,4724,9,4733,completed
3753,rigid,12981,17705,17714,4724,9,4733,completed
3754,rigid,12981,17705,17714,4724,9,4733,completed
3755,rigid,12981,17705,17714,4724,9,4733,completed
3756,rigid,12981,17705,17714,4724,9,4733,completed
3757,rigid,12981,17705,17714,4724,9,4733,completed
3758,rigid,12981,17705,17714,4724,9,4733,completed
3759,rigid,12981,17705,17714,4724,9,4733,completed
3760,rigid,12981,17705,17714,4724,9,4733,completed
3761,rigid,12981,17705,17714,4724,9,4733,completed
3762,rigid,12981,17706,17723,4725,17,4742,completed
3763,rigid,12981,17706,17728,4725,22,4747,completed
3764,rigid,12981,17706,17725,4725,19,4744,completed
3765,rigid,12981,17706,17722,4725,16,4741,completed
3766,rigid,12981,17706,17722,4725,16,4741,completed
3767,rigid,12981,17706,17721,4725,15,4740,completed
3768,rigid,12981,17706,17715,4725,9,4734,completed
3769,rigid,12981,17706,17715,4725,9,4734,completed
3770,rigid,12981,17706,17715,4725,9,4734,completed
3771,rigid,12981,17707,17716,4726,9,4735,completed
3772,rigid,12981,17707,17716,4726,9,4735,completed
3773,rigid,12981,17707,17723,4726,16,4742,completed
3774,rigid,12981,17707,17720,4726,13,4739,completed
3775,rigid,12981,17707,17717,4726,10,4736,completed
3776,rigid,12981,17707,17720,4726,13,4739,completed
3777,rigid,12981,17707,17720,4726,13,4739,completed
3778,rigid,12981,17707,17723,4726,16,4742,completed
3779,rigid,12981,17707,17725,4726,18,4744,completed
3780,rigid,12981,17710,17727,4729,17,4746,completed
3781,rigid,12981,17710,17719,4729,9,4738,completed
3782,rigid,12981,17710,17719,4729,9,4738,completed
3783,rigid,12981,17710,17719,4729,9,4738,completed
3784,rigid,12981,17710,17719,4729,9,4738,completed
3785,rigid,12981,17711,17720,4730,9,4739,completed
3786,rigid,12981,17711,17724,4730,13,4743,completed
3787,rigid,12981,17711,17724,4730,13,4743,completed
3788,rigid,12981,17711,17720,4730,9,4739,completed
3789,rigid,12981,17711,17720,4730,9,4739,completed
3790,rigid,12981,17711,17720,4730,9,4739,completed
3791,rigid,12981,17711,17741,4730,30,4760,completed
3792,rigid,12981,17711,17727,4730,16,4746,completed
3793,rigid,12981,17711,17727,4730,16,4746,completed
3794,rigid,12981,17711,17725,4730,14,4744,completed
3795,rigid,12981,17711,17721,4730,10,4740,completed
3796,rigid,12981,17712,17726,4731,14,4745,completed
3797,rigid,12981,17712,17728,4731,16,4747,completed
3798,rigid,12981,17712,17721,4731,9,4740,completed
3799,rigid,12981,17712,17721,4731,9,4740,completed
3800,rigid,12981,17712,17721,4731,9,4740,completed
3801,rigid,12981,17712,17721,4731,9,4740,completed
3802,rigid,12981,17712,17735,4731,23,4754,completed
3803,rigid,12981,17712,17722,4731,10,4741,completed
3804,rigid,12981,17712,17722,4731,10,4741,completed
3805,rigid,12981,17712,17730,4731,18,4749,completed
3806,rigid,12981,17712,17733,4731,21,4752,completed
3807,rigid,12981,17712,17730,4731,18,4749,completed
3808,rigid,12981,17712,17721,4731,9,4740,completed
3809,rigid,12981,17712,17721,4731,9,4740,completed
3810,rigid,12981,17712,17721,4731,9,4740,completed
3811,rigid,12981,17712,17721,4731,9,4740,completed
3812,rigid,12981,17712,17723,4731,11,4742,completed
3813,rigid,12981,17712,17730,4731,18,4749,completed
3814,rigid,12981,17713,17727,4732,14,4746,completed
3815,rigid,12981,17713,17730,4732,17,4749,completed
3816,rigid,12981,17713,17722,4732,9,4741,completed
3817,rigid,12981,17713,17722,4732,9,4741,completed
3818,rigid,12981,17713,17722,4732,9,4741,completed
3819,rigid,12981,17713,17722,4732,9,4741,completed
3820,rigid,12981,17713,17722,4732,9,4741,completed
3821,rigid,12981,17713,17722,4732,9,4741,completed
3822,rigid,12981,17713,17722,4732,9,4741,completed
3823,rigid,12981,17713,17722,4732,9,4741,completed
3824,rigid,12981,17714,17723,4733,9,4742,completed
3825,rigid,12981,17714,17723,4733,9,4742,completed
3826,rigid,12981,17714,17723,4733,9,4742,completed
3827,rigid,12981,17714,17723,4733,9,4742,completed
3828,rigid,12981,17714,17723,4733,9,4742,completed
3829,rigid,12981,17714,17728,4733,14,4747,completed
3830,rigid,12981,17714,17732,4733,18,4751,completed
3831,rigid,12981,17714,17740,4733,26,4759,completed
3832,rigid,12981,17714,17724,4733,10,4743,completed
3833,rigid,12981,17714,17733,4733,19,4752,completed
3834,rigid,12981,17714,17733,4733,19,4752,completed
3835,rigid,12981,17714,17724,4733,10,4743,completed
3836,rigid,12981,17714,17730,4733,16,4749,completed
3837,rigid,12981,17714,17723,4733,9,4742,completed
3838,rigid,12981,17714,17723,4733,9,4742,completed
3839,rigid,12981,17714,17723,4733,9,4742,completed
3840,rigid,12981,17714,17723,4733,9,4742,completed
3841,rigid,12981,17714,17723,4733,9,4742,completed
3842,rigid,12981,17714,17723,4733,9,4742,completed
3843,rigid,12981,17714,17723,4733,9,4742,completed
3844,rigid,12981,17714,17723,4733,9,4742,completed
3845,rigid,12981,17714,17730,4733,16,4749,completed
3846,rigid,12981,17714,17723,4733,9,4742,completed
3847,rigid,12981,17714,17723,4733,9,4742,completed
3848,rigid,12981,17714,17723,4733,9,4742,completed
3849,rigid,12981,17714,17723,4733,9,4742,completed
3850,rigid,12981,17714,17723,4733,9,4742,completed
3851,rigid,12981,17714,17723,4733,9,4742,completed
3852,rigid,12981,17714,17723,4733,9,4742,completed
3853,rigid,12981,17714,17723,4733,9,4742,completed
3854,rigid,12981,17714,17723,4733,9,4742,completed
3855,rigid,12981,17714,17724,4733,10,4743,completed
3856,rigid,12981,17714,17723,4733,9,4742,completed
3857,rigid,12981,17714,17723,4733,9,4742,completed
3858,rigid,12981,17714,17723,4733,9,4742,completed
3859,rigid,12981,17714,17723,4733,9,4742,completed
3860,rigid,12981,17714,17724,4733,10,4743,completed
3861,rigid,12981,17714,17732,4733,18,4751,completed
3862,rigid,12981,17714,17724,4733,10,4743,completed
3863,rigid,12984,17717,17809,4733,92,4825,completed
3864,rigid,12984,17720,17784,4736,64,4800,completed
3865,rigid,12984,17721,17800,4737,79,4816,completed
3866,rigid,12984,17722,17805,4738,83,4821,completed
3867,rigid,12984,17723,17869,4739,146,4885,completed
3868,rigid,12985,17728,17799,4743,71,4814,completed
3869,rigid,12985,17732,17795,4747,63,4810,completed
3870,rigid,12985,17734,17805,4749,71,4820,completed
3871,rigid,12985,17736,17827,4751,91,4842,completed
3872,rigid,12985,17739,17854,4754,115,4869,completed
3873,rigid,12985,17741,18207,4756,466,5222,completed
3874,rigid,12985,17749,18129,4764,380,5144,completed
3875,rigid,12985,17755,17890,4770,135,4905,completed
3876,rigid,12985,17759,18004,4774,245,5019,completed
3877,rigid,12985,17759,18054,4774,295,5069,completed
3878,rigid,12985,17761,18110,4776,349,5125,completed
3879,rigid,12985,17775,18173,4790,398,5188,completed
3880,rigid,12990,17776,17785,4786,9,4795,completed
3881,rigid,12990,17776,17786,4786,10,4796,completed
3882,rigid,12990,17776,17786,4786,10,4796,completed
3883,rigid,12990,17776,17785,4786,9,4795,completed
3884,rigid,12990,17776,17785,4786,9,4795,completed
3885,rigid,12990,17776,17785,4786,9,4795,completed
3886,rigid,12990,17776,17785,4786,9,4795,completed
3887,rigid,12990,17776,17785,4786,9,4795,completed
3888,rigid,12990,17776,17785,4786,9,4795,completed
3889,rigid,12990,17776,17785,4786,9,4795,completed
3890,rigid,12990,17776,17786,4786,10,4796,completed
3891,rigid,12990,17776,17785,4786,9,4795,completed
3892,rigid,12990,17776,17785,4786,9,4795,completed
3893,rigid,12990,17776,17784,4786,8,4794,completed
3894,rigid,12990,17776,17784,4786,8,4794,completed
3895,rigid,12990,17776,17785,4786,9,4795,completed
3896,rigid,12990,17776,17785,4786,9,4795,completed
3897,rigid,12990,17776,17785,4786,9,4795,completed
3898,rigid,12990,17776,17785,4786,9,4795,completed
3899,rigid,12990,17776,17784,4786,8,4794,completed
3900,rigid,12990,17776,17784,4786,8,4794,completed
3901,rigid,12990,17776,17784,4786,8,4794,completed
3902,rigid,12990,17776,17784,4786,8,4794,completed
3903,rigid,12990,17776,17785,4786,9,4795,completed
3904,rigid,12990,17776,17785,4786,9,4795,completed
3905,rigid,12990,17776,17785,4786,9,4795,completed
3906,rigid,12990,17776,17785,4786,9,4795,completed
3907,rigid,12990,17777,17786,4787,9,4796,completed
3908,rigid,12990,17777,17786,4787,9,4796,completed
3909,rigid,12990,17777,17786,4787,9,4796,completed
3910,rigid,12990,17777,17790,4787,13,4800,completed
3911,rigid,12990,17777,17786,4787,9,4796,completed
3912,rigid,12990,17777,17786,4787,9,4796,completed
3913,rigid,12990,17777,17786,4787,9,4796,completed
3914,rigid,12990,17777,17786,4787,9,4796,completed
3915,rigid,12990,17777,17786,4787,9,4796,completed
3916,rigid,12990,17777,17790,4787,13,4800,completed
3917,rigid,12990,17779,17935,4789,156,4945,completed
3918,rigid,12990,17779,17788,4789,9,4798,completed
3919,rigid,12990,17779,17788,4789,9,4798,completed
3920,rigid,12990,17779,17788,4789,9,4798,completed
3921,rigid,12990,17779,17789,4789,10,4799,completed
3922,rigid,12990,17779,17789,4789,10,4799,completed
3923,rigid,12990,17779,17789,4789,10,4799,completed
3924,rigid,12990,17779,17788,4789,9,4798,completed
3925,rigid,12990,17779,17788,4789,9,4798,completed
3926,rigid,12990,17780,17789,4790,9,4799,completed
3927,rigid,12990,17780,17789,4790,9,4799,completed
3928,rigid,12990,17780,17789,4790,9,4799,completed
3929,rigid,12990,17780,17789,4790,9,4799,completed
3930,rigid,12990,17780,17789,4790,9,4799,completed
3931,rigid,12990,17780,17789,4790,9,4799,completed
3932,rigid,12990,17780,17789,4790,9,4799,completed
3933,rigid,12990,17780,17789,4790,9,4799,completed
3934,rigid,12990,17780,17789,4790,9,4799,completed
3935,rigid,12990,17784,17793,4794,9,4803,completed
3936,rigid,12990,17784,17793,4794,9,4803,completed
3937,rigid,12990,17784,17793,4794,9,4803,completed
3938,rigid,12990,17784,17793,4794,9,4803,completed
3939,rigid,12990,17784,17793,4794,9,4803,completed
3940,rigid,12990,17784,17795,4794,11,4805,completed
3941,rigid,12990,17784,17793,4794,9,4803,completed
3942,rigid,12990,17784,17796,4794,12,4806,completed
3943,rigid,12990,17784,17794,4794,10,4804,completed
3944,rigid,12990,17784,17794,4794,10,4804,completed
3945,rigid,12990,17784,17794,4794,10,4804,completed
3946,rigid,12990,17784,17794,4794,10,4804,completed
3947,rigid,12990,17784,17799,4794,15,4809,completed
3948,rigid,12990,17784,17798,4794,14,4808,completed
3949,rigid,12990,17784,17795,4794,11,4805,completed
3950,rigid,12990,17784,17793,4794,9,4803,completed
3951,rigid,12990,17784,17795,4794,11,4805,completed
3952,rigid,12990,17784,17797,4794,13,4807,completed
3953,rigid,12991,17784,17793,4793,9,4802,completed
3954,rigid,12991,17784,17793,4793,9,4802,completed
3955,rigid,12991,17784,17793,4793,9,4802,completed
3956,rigid,12991,17784,17797,4793,13,4806,completed
3957,rigid,12991,17784,17794,4793,10,4803,completed
3958,rigid,12991,17784,17794,4793,10,4803,completed
3959,rigid,12991,17784,17794,4793,10,4803,completed
3960,rigid,12991,17784,17793,4793,9,4802,completed
3961,rigid,12991,17784,17793,4793,9,4802,completed
3962,rigid,12991,17784,17797,4793,13,4806,completed
3963,rigid,12991,17784,17797,4793,13,4806,completed
3964,rigid,12991,17784,17793,4793,9,4802,completed
3965,rigid,12991,17784,17793,4793,9,4802,completed
3966,rigid,12991,17784,17793,4793,9,4802,completed
3967,rigid,12991,17784,17793,4793,9,4802,completed
3968,rigid,12991,17784,17793,4793,9,4802,completed
3969,rigid,12991,17784,17793,4793,9,4802,completed
3970,rigid,12991,17784,17802,4793,18,4811,completed
3971,rigid,12991,17784,17796,4793,12,4805,completed
3972,rigid,12991,17784,17800,4793,16,4809,completed
3973,rigid,12991,17784,17796,4793,12,4805,completed
3974,rigid,12991,17784,17793,4793,9,4802,completed
3975,rigid,12991,17784,17793,4793,9,4802,completed
3976,rigid,12991,17784,17793,4793,9,4802,completed
3977,rigid,12991,17785,17794,4794,9,4803,completed
3978,rigid,12991,17785,17794,4794,9,4803,completed
3979,rigid,12991,17785,17794,4794,9,4803,completed
3980,rigid,12991,17785,17800,4794,15,4809,completed
3981,rigid,12991,17785,17798,4794,13,4807,completed
3982,rigid,12991,17785,17800,4794,15,4809,completed
3983,rigid,12991,17785,17798,4794,13,4807,completed
3984,rigid,12992,17785,17794,4793,9,4802,completed
3985,rigid,12992,17785,17794,4793,9,4802,completed
3986,rigid,12992,17785,17794,4793,9,4802,completed
3987,rigid,12992,17785,17794,4793,9,4802,completed
3988,rigid,12992,17785,17794,4793,9,4802,completed
3989,rigid,12992,17785,17794,4793,9,4802,completed
3990,rigid,12992,17785,17794,4793,9,4802,completed
3991,rigid,12992,17785,17794,4793,9,4802,completed
3992,rigid,12992,17785,17801,4793,16,4809,completed
3993,rigid,12992,17785,17795,4793,10,4803,completed
3994,rigid,12993,17785,17794,4792,9,4801,completed
3995,rigid,12993,17786,17795,4793,9,4802,completed
3996,rigid,12994,17786,17796,4792,10,4802,completed
3997,rigid,12994,17786,17795,4792,9,4801,completed
3998,rigid,12994,17786,17801,4792,15,4807,completed
3999,rigid,12994,17786,17801,4792,15,4807,completed
4000,rigid,12994,17786,17795,4792,9,4801,completed
4001,rigid,12994,17786,17795,4792,9,4801,completed
4002,rigid,12995,17786,17795,4791,9,4800,completed
4003,rigid,12995,17786,17795,4791,9,4800,completed
4004,rigid,12996,17786,17797,4790,11,4801,completed
4005,rigid,12996,17786,17797,4790,11,4801,completed
4006,rigid,12996,17788,17799,4792,11,4803,completed
4007,rigid,12996,17788,17799,4792,11,4803,completed
4008,rigid,12996,17788,17799,4792,11,4803,completed
4009,rigid,12997,17788,17799,4791,11,4802,completed
4010,rigid,12997,17788,17797,4791,9,4800,completed
4011,rigid,12997,17789,17798,4792,9,4801,completed
4012,rigid,12997,17789,17805,4792,16,4808,completed
4013,rigid,12998,17789,17799,4791,10,4801,completed
4014,rigid,12998,17789,17799,4791,10,4801,completed
4015,rigid,12998,17789,17806,4791,17,4808,completed
4016,rigid,12998,17789,17804,4791,15,4806,completed
4017,rigid,12998,17789,17805,4791,16,4807,completed
4018,rigid,12998,17789,17805,4791,16,4807,completed
4019,rigid,12998,17789,17803,4791,14,4805,completed
4020,rigid,12998,17789,17805,4791,16,4807,completed
4021,rigid,12998,17793,17811,4795,18,4813,completed
4022,rigid,12999,17793,17802,4794,9,4803,completed
4023,rigid,12999,17793,17804,4794,11,4805,completed
4024,rigid,12999,17793,17803,4794,10,4804,completed
4025,rigid,12999,17793,17809,4794,16,4810,completed
4026,rigid,12999,17793,18715,4794,922,5716,completed
4027,rigid,12999,17794,19522,4795,1728,6523,completed
4028,rigid,12999,17794,18086,4795,292,5087,completed
4029,rigid,12999,17794,17802,4795,8,4803,completed
4030,rigid,12999,17794,17802,4795,8,4803,completed
4031,rigid,12999,17794,17802,4795,8,4803,completed
4032,rigid,12999,17794,17802,4795,8,4803,completed
4033,rigid,12999,17795,17804,4796,9,4805,completed
4034,rigid,12999,17795,17804,4796,9,4805,completed
4035,rigid,12999,17795,17804,4796,9,4805,completed
4036,rigid,12999,17795,17803,4796,8,4804,completed
4037,rigid,12999,17795,17803,4796,8,4804,completed
4038,rigid,12999,17795,17803,4796,8,4804,completed
4039,rigid,12999,17795,17803,4796,8,4804,completed
4040,rigid,12999,17795,17812,4796,17,4813,completed
4041,rigid,12999,17795,17803,4796,8,4804,completed
4042,rigid,12999,17795,17803,4796,8,4804,completed
4043,rigid,12999,17795,17803,4796,8,4804,completed
4044,rigid,12999,17795,17803,4796,8,4804,completed
4045,rigid,12999,17795,17803,4796,8,4804,completed
4046,rigid,12999,17795,17803,4796,8,4804,completed
4047,rigid,12999,17795,17804,4796,9,4805,completed
4048,rigid,12999,17795,17804,4796,9,4805,completed
4049,rigid,12999,17795,17804,4796,9,4805,completed
4050,rigid,12999,17795,17804,4796,9,4805,completed
4051,rigid,12999,17795,17803,4796,8,4804,completed
4052,rigid,12999,17795,17803,4796,8,4804,completed
4053,rigid,12999,17795,17803,4796,8,4804,completed
4054,rigid,12999,17795,17805,4796,10,4806,completed
4055,rigid,12999,17795,17805,4796,10,4806,completed
4056,rigid,12999,17795,17812,4796,17,4813,completed
4057,rigid,12999,17795,17804,4796,9,4805,completed
4058,rigid,12999,17795,17803,4796,8,4804,completed
4059,rigid,12999,17795,17803,4796,8,4804,completed
4060,rigid,13000,17795,17803,4795,8,4803,completed
4061,rigid,13000,17795,17803,4795,8,4803,completed
4062,rigid,13000,17795,17803,4795,8,4803,completed
4063,rigid,13000,17795,17808,4795,13,4808,completed
4064,rigid,13000,17795,17803,4795,8,4803,completed
4065,rigid,13000,17795,17804,4795,9,4804,completed
4066,rigid,13000,17795,17804,4795,9,4804,completed
4067,rigid,13000,17795,17804,4795,9,4804,completed
4068,rigid,13000,17795,17803,4795,8,4803,completed
4069,rigid,13000,17795,17803,4795,8,4803,completed
4070,rigid,13000,17795,17803,4795,8,4803,completed
4071,rigid,13000,17795,17803,4795,8,4803,completed
4072,rigid,13000,17795,17803,4795,8,4803,completed
4073,rigid,13000,17795,17804,4795,9,4804,completed
4074,rigid,13000,17795,17814,4795,19,4814,completed
4075,rigid,13000,17795,17804,4795,9,4804,completed
4076,rigid,13000,17795,17804,4795,9,4804,completed
4077,rigid,13000,17795,17804,4795,9,4804,completed
4078,rigid,13000,17797,19161,4797,1364,6161,completed
4079,rigid,13000,17798,18338,4798,540,5338,completed
4080,rigid,13000,17799,18868,4799,1069,5868,completed
4081,rigid,13000,17799,17807,4799,8,4807,completed
4082,rigid,13000,17799,17807,4799,8,4807,completed
4083,rigid,13000,17799,17807,4799,8,4807,completed
4084,rigid,13000,17799,17807,4799,8,4807,completed
4085,rigid,13000,17799,17807,4799,8,4807,completed
4086,rigid,13000,17799,17807,4799,8,4807,completed
4087,rigid,13000,17799,17807,4799,8,4807,completed
4088,rigid,13000,17799,17807,4799,8,4807,completed
4089,rigid,13000,17799,17807,4799,8,4807,completed
4090,rigid,13000,17799,17807,4799,8,4807,completed
4091,rigid,13000,17799,17807,4799,8,4807,completed
4092,rigid,13000,17799,17807,4799,8,4807,completed
4093,rigid,13000,17799,17807,4799,8,4807,completed
4094,rigid,13000,17799,17807,4799,8,4807,completed
4095,rigid,13000,17799,17807,4799,8,4807,completed
4096,rigid,13000,17799,17816,4799,17,4816,completed
4097,rigid,13000,17799,17807,4799,8,4807,completed
4098,rigid,13000,17799,17807,4799,8,4807,completed
4099,rigid,13000,17799,17807,4799,8,4807,completed
4100,rigid,13000,17799,17807,4799,8,4807,completed
4101,rigid,13000,17799,17817,4799,18,4817,completed
4102,rigid,13000,17799,17815,4799,16,4815,completed
4103,rigid,13000,17799,17815,4799,16,4815,completed
4104,rigid,13000,17799,17809,4799,10,4809,completed
4105,rigid,13000,17799,17809,4799,10,4809,completed
4106,rigid,13000,17799,17808,4799,9,4808,completed
4107,rigid,13000,17799,17808,4799,9,4808,completed
4108,rigid,13000,17799,17808,4799,9,4808,completed
4109,rigid,13000,17799,17808,4799,9,4808,completed
4110,rigid,13000,17799,17809,4799,10,4809,completed
4111,rigid,13000,17799,17811,4799,12,4811,completed
4112,rigid,13000,17799,17808,4799,9,4808,completed
4113,rigid,13000,17799,17808,4799,9,4808,completed
4114,rigid,13000,17799,17808,4799,9,4808,completed
4115,rigid,13000,17799,17808,4799,9,4808,completed
4116,rigid,13000,17799,17808,4799,9,4808,completed
4117,rigid,13000,17799,17808,4799,9,4808,completed
4118,rigid,13000,17799,17808,4799,9,4808,completed
4119,rigid,13000,17799,17808,4799,9,4808,completed
4120,rigid,13000,17799,17808,4799,9,4808,completed
4121,rigid,13000,17799,17808,4799,9,4808,completed
4122,rigid,13000,17800,17818,4800,18,4818,completed
4123,rigid,13000,17800,17809,4800,9,4809,completed
4124,rigid,13000,17800,17809,4800,9,4809,completed
4125,rigid,13001,17800,17809,4799,9,4808,completed
4126,rigid,13001,17800,17812,4799,12,4811,completed
4127,rigid,13001,17800,17811,4799,11,4810,completed
4128,rigid,13001,17800,17809,4799,9,4808,completed
4129,rigid,13001,17800,17809,4799,9,4808,completed
4130,rigid,13001,17800,17809,4799,9,4808,completed
4131,rigid,13001,17800,17809,4799,9,4808,completed
4132,rigid,13001,17800,17808,4799,8,4807,completed
4133,rigid,13001,17800,17808,4799,8,4807,completed
4134,rigid,13001,17800,17808,4799,8,4807,completed
4135,rigid,13001,17800,17808,4799,8,4807,completed
4136,rigid,13001,17800,18872,4799,1072,5871,completed
4137,rigid,13001,17800,18675,4799,875,5674,completed
4138,rigid,13001,17801,18891,4800,1090,5890,completed
4139,rigid,13001,17801,17810,4800,9,4809,completed
4140,rigid,13001,17802,17811,4801,9,4810,completed
4141,rigid,13001,17802,17811,4801,9,4810,completed
4142,rigid,13001,17802,17811,4801,9,4810,completed
4143,rigid,13001,17802,17812,4801,10,4811,completed
4144,rigid,13001,17802,17812,4801,10,4811,completed
4145,rigid,13001,17802,17818,4801,16,4817,completed
4146,rigid,13001,17802,17811,4801,9,4810,completed
4147,rigid,13001,17802,17811,4801,9,4810,completed
4148,rigid,13001,17802,17811,4801,9,4810,completed
4149,rigid,13001,17802,17811,4801,9,4810,completed
4150,rigid,13001,17802,17811,4801,9,4810,completed
4151,rigid,13001,17802,17811,4801,9,4810,completed
4152,rigid,13001,17803,17812,4802,9,4811,completed
4153,rigid,13001,17803,17812,4802,9,4811,completed
4154,rigid,13001,17803,17812,4802,9,4811,completed
4155,rigid,13001,17803,17812,4802,9,4811,completed
4156,rigid,13002,17803,17812,4801,9,4810,completed
4157,rigid,13002,17803,17817,4801,14,4815,completed
4158,rigid,13002,17803,17816,4801,13,4814,completed
4159,rigid,13002,17803,17816,4801,13,4814,completed
4160,rigid,13002,17803,17813,4801,10,4811,completed
4161,rigid,13002,17803,17813,4801,10,4811,completed
4162,rigid,13002,17803,17813,4801,10,4811,completed
4163,rigid,13002,17803,17814,4801,11,4812,completed
4164,rigid,13002,17803,17814,4801,11,4812,completed
4165,rigid,13002,17803,17817,4801,14,4815,completed
4166,rigid,13002,17803,17818,4801,15,4816,completed
4167,rigid,13003,17803,17817,4800,14,4814,completed
4168,rigid,13003,17803,17815,4800,12,4812,completed
4169,rigid,13003,17803,17816,4800,13,4813,completed
4170,rigid,13003,17803,17812,4800,9,4809,completed
4171,rigid,13003,17803,17811,4800,8,4808,completed
4172,rigid,13004,17803,17811,4799,8,4807,completed
4173,rigid,13004,17803,17811,4799,8,4807,completed
4174,rigid,13004,17803,17811,4799,8,4807,completed
4175,rigid,13004,17803,17811,4799,8,4807,completed
4176,rigid,13004,17803,17811,4799,8,4807,completed
4177,rigid,13004,17803,17811,4799,8,4807,completed
4178,rigid,13004,17804,17812,4800,8,4808,completed
4179,rigid,13004,17804,17812,4800,8,4808,completed
4180,rigid,13004,17804,17812,4800,8,4808,completed
4181,rigid,13004,17804,17816,4800,12,4812,completed
4182,rigid,13004,17804,17812,4800,8,4808,completed
4183,rigid,13004,17804,17812,4800,8,4808,completed
4184,rigid,13004,17804,17812,4800,8,4808,completed
4185,rigid,13004,17804,17812,4800,8,4808,completed
4186,rigid,13004,17804,17812,4800,8,4808,completed
4187,rigid,13004,17804,17812,4800,8,4808,completed
4188,rigid,13004,17804,17813,4800,9,4809,completed
4189,rigid,13005,17804,17812,4799,8,4807,completed
4190,rigid,13005,17804,17812,4799,8,4807,completed
4191,rigid,13005,17804,17812,4799,8,4807,completed
4192,rigid,13005,17804,17812,4799,8,4807,completed
4193,rigid,13005,17804,17816,4799,12,4811,completed
4194,rigid,13005,17804,17815,4799,11,4810,completed
4195,rigid,13005,17804,17815,4799,11,4810,completed
4196,rigid,13005,17804,17814,4799,10,4809,completed
4197,rigid,13005,17804,17814,4799,10,4809,completed
4198,rigid,13006,17804,17814,4798,10,4808,completed
4199,rigid,13006,17804,17814,4798,10,4808,completed
4200,rigid,13006,17804,17815,4798,11,4809,completed
4201,rigid,13007,17804,17816,4797,12,4809,completed
4202,rigid,13007,17804,17816,4797,12,4809,completed
4203,rigid,13007,17804,17813,4797,9,4806,completed
4204,rigid,13007,17805,17814,4798,9,4807,completed
4205,rigid,13007,17805,17814,4798,9,4807,completed
4206,rigid,13007,17805,17820,4798,15,4813,completed
4207,rigid,13007,17805,17814,4798,9,4807,completed
4208,rigid,13007,17805,17814,4798,9,4807,completed
4209,rigid,13007,17805,17814,4798,9,4807,completed
4210,rigid,13008,17805,17814,4797,9,4806,completed
4211,rigid,13008,17805,17815,4797,10,4807,completed
4212,rigid,13008,17805,17813,4797,8,4805,completed
4213,rigid,13008,17805,17814,4797,9,4806,completed
4214,rigid,13008,17805,17813,4797,8,4805,completed
4215,rigid,13008,17805,17813,4797,8,4805,completed
4216,rigid,13008,17805,17813,4797,8,4805,completed
4217,rigid,13008,17805,17813,4797,8,4805,completed
4218,rigid,13008,17805,17813,4797,8,4805,completed
4219,rigid,13008,17805,17813,4797,8,4805,completed
4220,rigid,13008,17805,17813,4797,8,4805,completed
4221,rigid,13008,17805,17813,4797,8,4805,completed
4222,rigid,13008,17805,17813,4797,8,4805,completed
4223,rigid,13008,17805,17814,4797,9,4806,completed
4224,rigid,13008,17805,17813,4797,8,4805,completed
4225,rigid,13008,17805,17813,4797,8,4805,completed
4226,rigid,13008,17805,17813,4797,8,4805,completed
4227,rigid,13008,17805,17813,4797,8,4805,completed
4228,rigid,13008,17805,17813,4797,8,4805,completed
4229,rigid,13008,17805,17815,4797,10,4807,completed
4230,rigid,13008,17805,17813,4797,8,4805,completed
4231,rigid,13008,17805,17813,4797,8,4805,completed
4232,rigid,13008,17805,17814,4797,9,4806,completed
4233,rigid,13008,17805,17814,4797,9,4806,completed
4234,rigid,13008,17805,17813,4797,8,4805,completed
4235,rigid,13008,17805,17815,4797,10,4807,completed
4236,rigid,13009,17805,17813,4796,8,4804,completed
4237,rigid,13009,17805,17813,4796,8,4804,completed
4238,rigid,13009,17805,17813,4796,8,4804,completed
4239,rigid,13009,17805,17813,4796,8,4804,completed
4240,rigid,13009,17805,17813,4796,8,4804,completed
4241,rigid,13009,17805,17813,4796,8,4804,completed
4242,rigid,13009,17805,17813,4796,8,4804,completed
4243,rigid,13009,17805,17813,4796,8,4804,completed
4244,rigid,13009,17805,17813,4796,8,4804,completed
4245,rigid,13009,17805,17813,4796,8,4804,completed
4246,rigid,13009,17805,17813,4796,8,4804,completed
4247,rigid,13009,17805,17813,4796,8,4804,completed
4248,rigid,13009,17805,17813,4796,8,4804,completed
4249,rigid,13009,17805,17813,4796,8,4804,completed
4250,rigid,13009,17805,17813,4796,8,4804,completed
4251,rigid,13009,17805,17813,4796,8,4804,completed
4252,rigid,13009,17805,17813,4796,8,4804,completed
4253,rigid,13009,17805,17813,4796,8,4804,completed
4254,rigid,13009,17805,17813,4796,8,4804,completed
4255,rigid,13009,17805,17813,4796,8,4804,completed
4256,rigid,13009,17805,17815,4796,10,4806,completed
4257,rigid,13009,17805,17815,4796,10,4806,completed
4258,rigid,13009,17805,17813,4796,8,4804,completed
4259,rigid,13009,17805,17813,4796,8,4804,completed
4260,rigid,13009,17805,17813,4796,8,4804,completed
4261,rigid,13009,17805,17813,4796,8,4804,completed
4262,rigid,13009,17805,17813,4796,8,4804,completed
4263,rigid,13009,17805,17813,4796,8,4804,completed
4264,rigid,13009,17805,17813,4796,8,4804,completed
4265,rigid,13009,17805,17813,4796,8,4804,completed
4266,rigid,13009,17805,17813,4796,8,4804,completed
4267,rigid,13009,17805,17813,4796,8,4804,completed
4268,rigid,13009,17805,17813,4796,8,4804,completed
4269,rigid,13009,17805,17813,4796,8,4804,completed
4270,rigid,13009,17805,17813,4796,8,4804,completed
4271,rigid,13009,17805,17814,4796,9,4805,completed
4272,rigid,13009,17805,17813,4796,8,4804,completed
4273,rigid,13009,17805,17813,4796,8,4804,completed
4274,rigid,13009,17805,17813,4796,8,4804,completed
4275,rigid,13009,17805,17813,4796,8,4804,completed
4276,rigid,13009,17805,17813,4796,8,4804,completed
4277,rigid,13009,17805,17814,4796,9,4805,completed
4278,rigid,13009,17805,17814,4796,9,4805,completed
4279,rigid,13009,17805,17814,4796,9,4805,completed
4280,rigid,13009,17805,17814,4796,9,4805,completed
4281,rigid,13010,17805,17813,4795,8,4803,completed
4282,rigid,13010,17806,17814,4796,8,4804,completed
4283,rigid,13010,17807,17819,4797,12,4809,completed
4284,rigid,13010,17807,17815,4797,8,4805,completed
4285,rigid,13010,17807,17815,4797,8,4805,completed
4286,rigid,13010,17807,17815,4797,8,4805,completed
4287,rigid,13010,17807,17815,4797,8,4805,completed
4288,rigid,13010,17807,17815,4797,8,4805,completed
4289,rigid,13010,17807,17815,4797,8,4805,completed
4290,rigid,13010,17807,17815,4797,8,4805,completed
4291,rigid,13010,17807,17815,4797,8,4805,completed
4292,rigid,13010,17807,17815,4797,8,4805,completed
4293,rigid,13010,17807,17815,4797,8,4805,completed
4294,rigid,13010,17807,17815,4797,8,4805,completed
4295,rigid,13010,17807,17815,4797,8,4805,completed
4296,rigid,13010,17807,17815,4797,8,4805,completed
4297,rigid,13010,17807,17815,4797,8,4805,completed
4298,rigid,13010,17807,17821,4797,14,4811,completed
4299,rigid,13010,17807,17815,4797,8,4805,completed
4300,rigid,13010,17807,17815,4797,8,4805,completed
4301,rigid,13010,17807,17815,4797,8,4805,completed
4302,rigid,13010,17807,17815,4797,8,4805,completed
4303,rigid,13010,17807,17815,4797,8,4805,completed
4304,rigid,13010,17807,17815,4797,8,4805,completed
4305,rigid,13010,17807,17815,4797,8,4805,completed
4306,rigid,13010,17807,17817,4797,10,4807,completed
4307,rigid,13010,17807,17815,4797,8,4805,completed
4308,rigid,13010,17807,17815,4797,8,4805,completed
4309,rigid,13010,17807,17815,4797,8,4805,completed
4310,rigid,13010,17807,17816,4797,9,4806,completed
4311,rigid,13010,17808,17817,4798,9,4807,completed
4312,rigid,13010,17808,17817,4798,9,4807,completed
4313,rigid,13010,17808,17816,4798,8,4806,completed
4314,rigid,13010,17808,17816,4798,8,4806,completed
4315,rigid,13010,17808,17816,4798,8,4806,completed
4316,rigid,13010,17808,17816,4798,8,4806,completed
4317,rigid,13010,17808,17822,4798,14,4812,completed
4318,rigid,13010,17808,17816,4798,8,4806,completed
4319,rigid,13010,17808,17816,4798,8,4806,completed
4320,rigid,13010,17808,17816,4798,8,4806,completed
4321,rigid,13010,17808,17816,4798,8,4806,completed
4322,rigid,13010,17808,17816,4798,8,4806,completed
4323,rigid,13010,17808,17816,4798,8,4806,completed
4324,rigid,13010,17808,17816,4798,8,4806,completed
4325,rigid,13011,17808,17816,4797,8,4805,completed
4326,rigid,13011,17808,17816,4797,8,4805,completed
4327,rigid,13011,17808,17816,4797,8,4805,completed
4328,rigid,13011,17808,17816,4797,8,4805,completed
4329,rigid,13011,17808,17816,4797,8,4805,completed
4330,rigid,13011,17809,17817,4798,8,4806,completed
4331,rigid,13012,17809,17821,4797,12,4809,completed
4332,rigid,13012,17809,17822,4797,13,4810,completed
4333,rigid,13012,17809,17825,4797,16,4813,completed
4334,rigid,13012,17809,17818,4797,9,4806,completed
4335,rigid,13012,17809,17818,4797,9,4806,completed
4336,rigid,13012,17809,17818,4797,9,4806,completed
4337,rigid,13013,17809,17817,4796,8,4804,completed
4338,rigid,13013,17809,17817,4796,8,4804,completed
4339,rigid,13013,17809,17817,4796,8,4804,completed
4340,rigid,13013,17809,17817,4796,8,4804,completed
4341,rigid,13013,17809,17817,4796,8,4804,completed
4342,rigid,13013,17809,17817,4796,8,4804,completed
4343,rigid,13013,17809,17817,4796,8,4804,completed
4344,rigid,13013,17809,17817,4796,8,4804,completed
4345,rigid,13013,17809,17818,4796,9,4805,completed
4346,rigid,13013,17809,17818,4796,9,4805,completed
4347,rigid,13013,17809,17818,4796,9,4805,completed
4348,rigid,13013,17809,17820,4796,11,4807,completed
4349,rigid,13013,17809,17817,4796,8,4804,completed
4350,rigid,13013,17809,17817,4796,8,4804,completed
4351,rigid,13013,17809,17817,4796,8,4804,completed
4352,rigid,13013,17809,17820,4796,11,4807,completed
4353,rigid,13013,17809,17817,4796,8,4804,completed
4354,rigid,13013,17809,17817,4796,8,4804,completed
4355,rigid,13013,17809,17821,4796,12,4808,completed
4356,rigid,13013,17809,17822,4796,13,4809,completed
4357,rigid,13013,17809,17821,4796,12,4808,completed
4358,rigid,13013,17809,17817,4796,8,4804,completed
4359,rigid,13013,17809,17817,4796,8,4804,completed
4360,rigid,13013,17809,17817,4796,8,4804,completed
4361,rigid,13013,17809,17817,4796,8,4804,completed
4362,rigid,13014,17809,17817,4795,8,4803,completed
4363,rigid,13014,17809,17822,4795,13,4808,completed
4364,rigid,13014,17809,17819,4795,10,4805,completed
4365,rigid,13014,17809,17819,4795,10,4805,completed
4366,rigid,13014,17809,17817,4795,8,4803,completed
4367,rigid,13014,17809,17817,4795,8,4803,completed
4368,rigid,13014,17809,17817,4795,8,4803,completed
4369,rigid,13014,17809,17817,4795,8,4803,completed
4370,rigid,13015,17809,17821,4794,12,4806,completed
4371,rigid,13015,17809,17820,4794,11,4805,completed
4372,rigid,13015,17809,17821,4794,12,4806,completed
4373,rigid,13015,17809,17821,4794,12,4806,completed
4374,rigid,13016,17809,17819,4793,10,4803,completed
4375,rigid,13016,17809,17821,4793,12,4805,completed
4376,rigid,13016,17809,17817,4793,8,4801,completed
4377,rigid,13016,17809,17817,4793,8,4801,completed
4378,rigid,13016,17809,17817,4793,8,4801,completed
4379,rigid,13016,17809,17817,4793,8,4801,completed
4380,rigid,13016,17809,17817,4793,8,4801,completed
4381,rigid,13016,17809,17817,4793,8,4801,completed
4382,rigid,13016,17809,17819,4793,10,4803,completed
4383,rigid,13016,17809,17819,4793,10,4803,completed
4384,rigid,13016,17809,17817,4793,8,4801,completed
4385,rigid,13016,17809,17817,4793,8,4801,completed
4386,rigid,13016,17810,17818,4794,8,4802,completed
4387,rigid,13016,17811,17819,4795,8,4803,completed
4388,rigid,13016,17811,17819,4795,8,4803,completed
4389,rigid,13016,17811,17819,4795,8,4803,completed
4390,rigid,13016,17811,17819,4795,8,4803,completed
4391,rigid,13016,17811,17821,4795,10,4805,completed
4392,rigid,13017,17811,17819,4794,8,4802,completed
4393,rigid,13017,17811,17819,4794,8,4802,completed
4394,rigid,13017,17811,17819,4794,8,4802,completed
4395,rigid,13017,17811,17819,4794,8,4802,completed
4396,rigid,13017,17811,17819,4794,8,4802,completed
4397,rigid,13017,17811,17818,4794,7,4801,completed
4398,rigid,13017,17811,17818,4794,7,4801,completed
4399,rigid,13017,17811,17818,4794,7,4801,completed
4400,rigid,13017,17811,17827,4794,16,4810,completed
4401,rigid,13017,17811,17819,4794,8,4802,completed
4402,rigid,13017,17811,17822,4794,11,4805,completed
4403,rigid,13017,17811,17819,4794,8,4802,completed
4404,rigid,13017,17811,17819,4794,8,4802,completed
4405,rigid,13017,17811,17819,4794,8,4802,completed
4406,rigid,13017,17811,17819,4794,8,4802,completed
4407,rigid,13017,17811,17819,4794,8,4802,completed
4408,rigid,13017,17811,17819,4794,8,4802,completed
4409,rigid,13017,17811,17818,4794,7,4801,completed
4410,rigid,13017,17811,17818,4794,7,4801,completed
4411,rigid,13017,17811,17821,4794,10,4804,completed
4412,rigid,13017,17811,17818,4794,7,4801,completed
4413,rigid,13017,17811,17818,4794,7,4801,completed
4414,rigid,13017,17812,17819,4795,7,4802,completed
4415,rigid,13017,17812,17819,4795,7,4802,completed
4416,rigid,13017,17812,17820,4795,8,4803,completed
4417,rigid,13017,17812,17820,4795,8,4803,completed
4418,rigid,13017,17812,17820,4795,8,4803,completed
4419,rigid,13017,17812,17819,4795,7,4802,completed
4420,rigid,13017,17812,17819,4795,7,4802,completed
4421,rigid,13017,17812,17819,4795,7,4802,completed
4422,rigid,13017,17812,17819,4795,7,4802,completed
4423,rigid,13017,17812,17823,4795,11,4806,completed
4424,rigid,13017,17812,17820,4795,8,4803,completed
4425,rigid,13017,17812,17820,4795,8,4803,completed
4426,rigid,13017,17812,17821,4795,9,4804,completed
4427,rigid,13017,17812,17821,4795,9,4804,completed
4428,rigid,13017,17812,17821,4795,9,4804,completed
4429,rigid,13017,17812,17819,4795,7,4802,completed
4430,rigid,13017,17812,17819,4795,7,4802,completed
4431,rigid,13017,17812,17819,4795,7,4802,completed
4432,rigid,13017,17812,17819,4795,7,4802,completed
4433,rigid,13017,17812,17819,4795,7,4802,completed
4434,rigid,13017,17812,17819,4795,7,4802,completed
4435,rigid,13017,17812,17819,4795,7,4802,completed
4436,rigid,13017,17812,17824,4795,12,4807,completed
4437,rigid,13017,17812,17819,4795,7,4802,completed
4438,rigid,13017,17812,17819,4795,7,4802,completed
4439,rigid,13017,17812,17819,4795,7,4802,completed
4440,rigid,13017,17812,17819,4795,7,4802,completed
4441,rigid,13017,17812,17819,4795,7,4802,completed
4442,rigid,13017,17812,17819,4795,7,4802,completed
4443,rigid,13017,17812,17819,4795,7,4802,completed
4444,rigid,13017,17812,17819,4795,7,4802,completed
4445,rigid,13017,17812,17819,4795,7,4802,completed
4446,rigid,13017,17812,17862,4795,50,4845,completed
4447,rigid,13017,17812,17878,4795,66,4861,completed
4448,rigid,13017,17812,18081,4795,269,5064,completed
4449,rigid,13017,17812,17853,4795,41,4836,completed
4450,rigid,13018,17812,17850,4794,38,4832,completed
4451,rigid,13018,17812,17858,4794,46,4840,completed
4452,rigid,13018,17812,17857,4794,45,4839,completed
4453,rigid,13018,17812,18105,4794,293,5087,completed
4454,rigid,13018,17812,18063,4794,251,5045,completed
4455,rigid,13022,17812,17838,4790,26,4816,completed
4456,rigid,13022,17812,17823,4790,11,4801,completed
4457,rigid,13022,17813,17833,4791,20,4811,completed
4458,rigid,13022,17813,17825,4791,12,4803,completed
4459,rigid,13022,17813,17824,4791,11,4802,completed
4460,rigid,13022,17813,17884,4791,71,4862,completed
4461,rigid,13022,17813,17840,4791,27,4818,completed
4462,rigid,13022,17813,17825,4791,12,4803,completed
4463,rigid,13022,17813,17835,4791,22,4813,completed
4464,rigid,13022,17814,17834,4792,20,4812,completed
4465,rigid,13027,17814,19542,4787,1728,6515,completed
4466,rigid,13028,17815,19243,4787,1428,6215,completed
4467,rigid,13038,17815,17894,4777,79,4856,completed
4468,rigid,13038,17816,17885,4778,69,4847,completed
4469,rigid,13038,17816,17888,4778,72,4850,completed
4470,rigid,13038,17816,17871,4778,55,4833,completed
4471,rigid,13038,17817,17847,4779,30,4809,completed
4472,rigid,13038,17817,17896,4779,79,4858,completed
4473,rigid,13038,17817,17879,4779,62,4841,completed
4474,rigid,13038,17817,17895,4779,78,4857,completed
4475,rigid,13038,17818,17879,4780,61,4841,completed
4476,rigid,13038,17818,17855,4780,37,4817,completed
4477,rigid,13038,17819,17844,4781,25,4806,completed
4478,rigid,13038,17819,17874,4781,55,4836,completed
4479,rigid,13038,17819,17854,4781,35,4816,completed
4480,rigid,13038,17819,17830,4781,11,4792,completed
4481,rigid,13038,17819,17832,4781,13,4794,completed
4482,rigid,13040,17820,18252,4780,432,5212,completed
4483,rigid,13041,17820,17821,4779,1,4780,completed
4484,rigid,13052,17820,18630,4768,810,5578,completed
4485,rigid,13052,17823,18337,4771,514,5285,completed
4486,rigid,13056,17823,17847,4767,24,4791,completed
4487,rigid,13059,17823,17851,4764,28,4792,completed
4488,rigid,13063,17823,17856,4760,33,4793,completed
4489,rigid,13065,17823,17857,4758,34,4792,completed
4490,rigid,13068,17823,17862,4755,39,4794,completed
4491,rigid,13081,17823,17964,4742,141,4883,completed
4492,rigid,13084,17823,17878,4739,55,4794,completed
4493,rigid,13088,17823,17966,4735,143,4878,completed
4494,rigid,13088,17823,17824,4735,1,4736,completed
4495,rigid,13089,17823,17824,4734,1,4735,completed
4496,rigid,13089,17823,17824,4734,1,4735,completed
4497,rigid,13089,17823,17824,4734,1,4735,completed
4498,rigid,13089,17823,17824,4734,1,4735,completed
4499,rigid,13089,17823,17824,4734,1,4735,completed
4500,rigid,13090,17823,17832,4733,9,4742,completed
4501,rigid,13090,17823,17832,4733,9,4742,completed
4502,rigid,13090,17824,17833,4734,9,4743,completed
4503,rigid,13090,17824,17827,4734,3,4737,completed
4504,rigid,13090,17824,17827,4734,3,4737,completed
4505,rigid,13090,17824,17839,4734,15,4749,completed
4506,rigid,13090,17824,17859,4734,35,4769,completed
4507,rigid,13090,17824,17860,4734,36,4770,completed
4508,rigid,13090,17824,17839,4734,15,4749,completed
4509,rigid,13090,17824,17833,4734,9,4743,completed
4510,rigid,13090,17824,17827,4734,3,4737,completed
4511,rigid,13090,17824,17833,4734,9,4743,completed
4512,rigid,13090,17824,17835,4734,11,4745,completed
4513,rigid,13090,17824,17835,4734,11,4745,completed
4514,rigid,13090,17824,17827,4734,3,4737,completed
4515,rigid,13090,17824,17826,4734,2,4736,completed
4516,rigid,13090,17824,17826,4734,2,4736,completed
4517,rigid,13090,17824,17826,4734,2,4736,completed
4518,rigid,13090,17824,17826,4734,2,4736,completed
4519,rigid,13090,17824,17835,4734,11,4745,completed
4520,rigid,13090,17824,17835,4734,11,4745,completed
4521,rigid,13090,17824,17835,4734,11,4745,completed
4522,rigid,13090,17824,17826,4734,2,4736,completed
4523,rigid,13090,17824,17826,4734,2,4736,completed
4524,rigid,13090,17824,17833,4734,9,4743,completed
4525,rigid,13090,17824,17826,4734,2,4736,completed
4526,rigid,13090,17824,17826,4734,2,4736,completed
4527,rigid,13090,17824,17832,4734,8,4742,completed
4528,rigid,13090,17824,17826,4734,2,4736,completed
4529,rigid,13090,17825,17836,4735,11,4746,completed
4530,rigid,13090,17825,17836,4735,11,4746,completed
4531,rigid,13090,17825,17827,4735,2,4737,completed
4532,rigid,13090,17825,17827,4735,2,4737,completed
4533,rigid,13090,17825,17827,4735,2,4737,completed
4534,rigid,13090,17825,17833,4735,8,4743,completed
4535,rigid,13090,17825,17833,4735,8,4743,completed
4536,rigid,13090,17825,17833,4735,8,4743,completed
4537,rigid,13090,17825,17835,4735,10,4745,completed
4538,rigid,13090,17825,17836,4735,11,4746,completed
4539,rigid,13090,17825,17833,4735,8,4743,completed
4540,rigid,13090,17825,17827,4735,2,4737,completed
4541,rigid,13090,17825,17833,4735,8,4743,completed
4542,rigid,13090,17825,17827,4735,2,4737,completed
4543,rigid,13090,17825,17827,4735,2,4737,completed
4544,rigid,13090,17825,17827,4735,2,4737,completed
4545,rigid,13090,17825,17836,4735,11,4746,completed
4546,rigid,13090,17825,17836,4735,11,4746,completed
4547,rigid,13090,17825,17836,4735,11,4746,completed
4548,rigid,13090,17825,17827,4735,2,4737,completed
4549,rigid,13090,17825,17827,4735,2,4737,completed
4550,rigid,13090,17825,17827,4735,2,4737,completed
4551,rigid,13090,17825,17827,4735,2,4737,completed
4552,rigid,13090,17825,17833,4735,8,4743,completed
4553,rigid,13090,17825,17827,4735,2,4737,completed
4554,rigid,13090,17825,17827,4735,2,4737,completed
4555,rigid,13090,17825,17827,4735,2,4737,completed
4556,rigid,13090,17825,17827,4735,2,4737,completed
4557,rigid,13090,17825,17835,4735,10,4745,completed
4558,rigid,13090,17825,17827,4735,2,4737,completed
4559,rigid,13090,17825,17827,4735,2,4737,completed
4560,rigid,13090,17825,17827,4735,2,4737,completed
4561,rigid,13090,17825,17827,4735,2,4737,completed
4562,rigid,13090,17825,17836,4735,11,4746,completed
4563,rigid,13090,17825,17827,4735,2,4737,completed
4564,rigid,13090,17825,17827,4735,2,4737,completed
4565,rigid,13090,17825,17827,4735,2,4737,completed
4566,rigid,13090,17825,17833,4735,8,4743,completed
4567,rigid,13090,17825,17827,4735,2,4737,completed
4568,rigid,13090,17825,17833,4735,8,4743,completed
4569,rigid,13090,17825,17827,4735,2,4737,completed
4570,rigid,13090,17825,17836,4735,11,4746,completed
4571,rigid,13090,17826,17837,4736,11,4747,completed
4572,rigid,13090,17826,17834,4736,8,4744,completed
4573,rigid,13090,17826,17828,4736,2,4738,completed
4574,rigid,13090,17826,17828,4736,2,4738,completed
4575,rigid,13090,17826,17828,4736,2,4738,completed
4576,rigid,13090,17826,17834,4736,8,4744,completed
4577,rigid,13090,17826,17834,4736,8,4744,completed
4578,rigid,13090,17826,17828,4736,2,4738,completed
4579,rigid,13090,17826,17837,4736,11,4747,completed
4580,rigid,13090,17826,17837,4736,11,4747,completed
4581,rigid,13091,17827,17829,4736,2,4738,completed
4582,rigid,13091,17827,17835,4736,8,4744,completed
4583,rigid,13091,17827,17829,4736,2,4738,completed
4584,rigid,13091,17827,17829,4736,2,4738,completed
4585,rigid,13091,17827,17835,4736,8,4744,completed
4586,rigid,13091,17827,17835,4736,8,4744,completed
4587,rigid,13091,17827,17829,4736,2,4738,completed
4588,rigid,13091,17827,17838,4736,11,4747,completed
4589,rigid,13091,17827,17835,4736,8,4744,completed
4590,rigid,13091,17827,17837,4736,10,4746,completed
4591,rigid,13091,17827,17837,4736,10,4746,completed
4592,rigid,13091,17827,17837,4736,10,4746,completed
4593,rigid,13091,17827,17829,4736,2,4738,completed
4594,rigid,13091,17827,17829,4736,2,4738,completed
4595,rigid,13091,17827,17834,4736,7,4743,completed
4596,rigid,13091,17827,17835,4736,8,4744,completed
4597,rigid,13091,17827,17829,4736,2,4738,completed
4598,rigid,13091,17827,17838,4736,11,4747,completed
4599,rigid,13091,17827,17837,4736,10,4746,completed
4600,rigid,13093,17827,17829,4734,2,4736,completed
4601,rigid,13093,17827,17835,4734,8,4742,completed
4602,rigid,13093,17827,17838,4734,11,4745,completed
4603,rigid,13093,17827,17829,4734,2,4736,completed
4604,rigid,13093,17827,17829,4734,2,4736,completed
4605,rigid,13093,17827,17834,4734,7,4741,completed
4606,rigid,13093,17827,17838,4734,11,4745,completed
4607,rigid,13093,17827,17829,4734,2,4736,completed
4608,rigid,13093,17827,17829,4734,2,4736,completed
4609,rigid,13093,17827,17829,4734,2,4736,completed
4610,rigid,13093,17827,17834,4734,7,4741,completed
4611,rigid,13093,17827,17838,4734,11,4745,completed
4612,rigid,13093,17827,17834,4734,7,4741,completed
4613,rigid,13093,17827,17829,4734,2,4736,completed
4614,rigid,13093,17827,17829,4734,2,4736,completed
4615,rigid,13093,17827,17834,4734,7,4741,completed
4616,rigid,13093,17827,17834,4734,7,4741,completed
4617,rigid,13093,17827,17838,4734,11,4745,completed
4618,rigid,13093,17827,17838,4734,11,4745,completed
4619,rigid,13093,17827,17838,4734,11,4745,completed
4620,rigid,13093,17827,17829,4734,2,4736,completed
4621,rigid,13093,17827,17829,4734,2,4736,completed
4622,rigid,13093,17827,17829,4734,2,4736,completed
4623,rigid,13093,17827,17829,4734,2,4736,completed
4624,rigid,13093,17827,17829,4734,2,4736,completed
4625,rigid,13093,17827,17834,4734,7,4741,completed
4626,rigid,13093,17827,17838,4734,11,4745,completed
4627,rigid,13093,17827,17829,4734,2,4736,completed
4628,rigid,13093,17827,17834,4734,7,4741,completed
4629,rigid,13093,17827,17829,4734,2,4736,completed
4630,rigid,13093,17827,17829,4734,2,4736,completed
4631,rigid,13093,17827,17834,4734,7,4741,completed
4632,rigid,13093,17827,17838,4734,11,4745,completed
4633,rigid,13093,17827,17838,4734,11,4745,completed
4634,rigid,13093,17827,17829,4734,2,4736,completed
4635,rigid,13093,17827,17829,4734,2,4736,completed
4636,rigid,13093,17827,17829,4734,2,4736,completed
4637,rigid,13093,17827,17834,4734,7,4741,completed
4638,rigid,13093,17827,17829,4734,2,4736,completed
4639,rigid,13093,17827,17829,4734,2,4736,completed
4640,rigid,13093,17827,17829,4734,2,4736,completed
4641,rigid,13093,17827,17837,4734,10,4744,completed
4642,rigid,13093,17827,17829,4734,2,4736,completed
4643,rigid,13093,17827,17829,4734,2,4736,completed
4644,rigid,13093,17827,17829,4734,2,4736,completed
4645,rigid,13094,17827,17829,4733,2,4735,completed
4646,rigid,13094,17827,17834,4733,7,4740,completed
4647,rigid,13094,17827,17838,4733,11,4744,completed
4648,rigid,13095,17827,17829,4732,2,4734,completed
4649,rigid,13095,17827,17834,4732,7,4739,completed
4650,rigid,13095,17827,17838,4732,11,4743,completed
4651,rigid,13095,17827,17829,4732,2,4734,completed
4652,rigid,13095,17827,17838,4732,11,4743,completed
4653,rigid,13095,17827,17834,4732,7,4739,completed
4654,rigid,13095,17827,17829,4732,2,4734,completed
4655,rigid,13095,17827,17834,4732,7,4739,completed
4656,rigid,13095,17827,17828,4732,1,4733,completed
4657,rigid,13095,17827,17829,4732,2,4734,completed
4658,rigid,13095,17827,17829,4732,2,4734,completed
4659,rigid,13095,17827,17834,4732,7,4739,completed
4660,rigid,13095,17827,17838,4732,11,4743,completed
4661,rigid,13095,17827,17838,4732,11,4743,completed
4662,rigid,13095,17827,17838,4732,11,4743,completed
4663,rigid,13095,17827,17828,4732,1,4733,completed
4664,rigid,13095,17827,17828,4732,1,4733,completed
4665,rigid,13095,17827,17828,4732,1,4733,completed
4666,rigid,13095,17827,17834,4732,7,4739,completed
4667,rigid,13095,17827,17828,4732,1,4733,completed
4668,rigid,13095,17827,17829,4732,2,4734,completed
4669,rigid,13095,17827,17828,4732,1,4733,completed
4670,rigid,13095,17827,17828,4732,1,4733,completed
4671,rigid,13095,17827,17828,4732,1,4733,completed
4672,rigid,13096,17827,17828,4731,1,4732,completed
4673,rigid,13096,17827,17828,4731,1,4732,completed
4674,rigid,13097,17827,17996,4730,169,4899,completed
4675,rigid,13097,17827,17829,4730,2,4732,completed
4676,rigid,13097,17827,17834,4730,7,4737,completed
4677,rigid,13097,17827,17838,4730,11,4741,completed
4678,rigid,13097,17827,17829,4730,2,4732,completed
4679,rigid,13097,17827,17829,4730,2,4732,completed
4680,rigid,13097,17827,17834,4730,7,4737,completed
4681,rigid,13097,17827,17838,4730,11,4741,completed
4682,rigid,13097,17827,17829,4730,2,4732,completed
4683,rigid,13097,17827,17834,4730,7,4737,completed
4684,rigid,13097,17827,17829,4730,2,4732,completed
4685,rigid,13097,17827,17838,4730,11,4741,completed
4686,rigid,13097,17827,17834,4730,7,4737,completed
4687,rigid,13097,17827,17829,4730,2,4732,completed
4688,rigid,13097,17827,17838,4730,11,4741,completed
4689,rigid,13098,17827,17828,4729,1,4730,completed
4690,rigid,13098,17827,17834,4729,7,4736,completed
4691,rigid,13099,17827,17829,4728,2,4730,completed
4692,rigid,13099,17827,17838,4728,11,4739,completed
4693,rigid,13099,17827,17840,4728,13,4741,completed
4694,rigid,13099,17827,17834,4728,7,4735,completed
4695,rigid,13099,17827,17829,4728,2,4730,completed
4696,rigid,13099,17828,17830,4729,2,4731,completed
4697,rigid,13099,17828,17834,4729,6,4735,completed
4698,rigid,13099,17828,17834,4729,6,4735,completed
4699,rigid,13099,17828,17829,4729,1,4730,completed
4700,rigid,13099,17828,17839,4729,11,4740,completed
4701,rigid,13099,17828,17839,4729,11,4740,completed
4702,rigid,13099,17828,17829,4729,1,4730,completed
4703,rigid,13099,17828,17830,4729,2,4731,completed
4704,rigid,13099,17828,17829,4729,1,4730,completed
4705,rigid,13099,17828,17834,4729,6,4735,completed
4706,rigid,13099,17828,17838,4729,10,4739,completed
4707,rigid,13099,17828,17829,4729,1,4730,completed
4708,rigid,13099,17828,17834,4729,6,4735,completed
4709,rigid,13099,17828,17829,4729,1,4730,completed
4710,rigid,13099,17828,17839,4729,11,4740,completed
4711,rigid,13099,17828,17829,4729,1,4730,completed
4712,rigid,13100,17828,17834,4728,6,4734,completed
4713,rigid,13100,17828,17829,4728,1,4729,completed
4714,rigid,13100,17829,17985,4729,156,4885,completed
4715,rigid,13100,17829,17830,4729,1,4730,completed
4716,rigid,13100,17829,17840,4729,11,4740,completed
4717,rigid,13100,17829,17830,4729,1,4730,completed
4718,rigid,13100,17829,17835,4729,6,4735,completed
4719,rigid,13100,17829,17830,4729,1,4730,completed
4720,rigid,13100,17829,17830,4729,1,4730,completed
4721,rigid,13100,17829,17840,4729,11,4740,completed
4722,rigid,13100,17829,17840,4729,11,4740,completed
4723,rigid,13100,17829,17835,4729,6,4735,completed
4724,rigid,13101,17829,17831,4728,2,4730,completed
4725,rigid,13101,17829,17831,4728,2,4730,completed
4726,rigid,13101,17829,17840,4728,11,4739,completed
4727,rigid,13101,17829,17836,4728,7,4735,completed
4728,rigid,13101,17829,17830,4728,1,4729,completed
4729,rigid,13101,17829,17830,4728,1,4729,completed
4730,rigid,13101,17829,17830,4728,1,4729,completed
4731,rigid,13101,17829,17835,4728,6,4734,completed
4732,rigid,13101,17829,17839,4728,10,4738,completed
4733,rigid,13101,17829,17830,4728,1,4729,completed
4734,rigid,13101,17829,17836,4728,7,4735,completed
4735,rigid,13101,17829,17840,4728,11,4739,completed
4736,rigid,13101,17829,17830,4728,1,4729,completed
4737,rigid,13101,17829,17830,4728,1,4729,completed
4738,rigid,13101,17829,17830,4728,1,4729,completed
4739,rigid,13101,17829,17840,4728,11,4739,completed
4740,rigid,13101,17829,17836,4728,7,4735,completed
4741,rigid,13101,17829,17830,4728,1,4729,completed
4742,rigid,13101,17829,17836,4728,7,4735,completed
4743,rigid,13101,17829,17840,4728,11,4739,completed
4744,rigid,13101,17829,17831,4728,2,4730,completed
4745,rigid,13101,17829,17830,4728,1,4729,completed
4746,rigid,13101,17829,17835,4728,6,4734,completed
4747,rigid,13101,17829,17830,4728,1,4729,completed
4748,rigid,13101,17829,17830,4728,1,4729,completed
4749,rigid,13101,17829,17840,4728,11,4739,completed
4750,rigid,13101,17829,17840,4728,11,4739,completed
4751,rigid,13102,17829,17835,4727,6,4733,completed
4752,rigid,13102,17829,17830,4727,1,4728,completed
4753,rigid,13102,17829,17830,4727,1,4728,completed
4754,rigid,13102,17829,17835,4727,6,4733,completed
4755,rigid,13102,17829,17840,4727,11,4738,completed
4756,rigid,13102,17829,17835,4727,6,4733,completed
4757,rigid,13102,17829,17830,4727,1,4728,completed
4758,rigid,13102,17829,17840,4727,11,4738,completed
4759,rigid,13102,17829,17830,4727,1,4728,completed
4760,rigid,13102,17829,17836,4727,7,4734,completed
4761,rigid,13102,17829,17839,4727,10,4737,completed
4762,rigid,13102,17829,17830,4727,1,4728,completed
4763,rigid,13102,17829,17835,4727,6,4733,completed
4764,rigid,13102,17829,17830,4727,1,4728,completed
4765,rigid,13102,17829,17840,4727,11,4738,completed
4766,rigid,13102,17829,17840,4727,11,4738,completed
4767,rigid,13102,17829,17835,4727,6,4733,completed
4768,rigid,13102,17829,17830,4727,1,4728,completed
4769,rigid,13102,17829,17835,4727,6,4733,completed
4770,rigid,13102,17829,17840,4727,11,4738,completed
4771,rigid,13102,17829,17830,4727,1,4728,completed
4772,rigid,13102,17829,17835,4727,6,4733,completed
4773,rigid,13102,17829,17840,4727,11,4738,completed
4774,rigid,13102,17829,17830,4727,1,4728,completed
4775,rigid,13102,17830,17832,4728,2,4730,completed
4776,rigid,13103,17830,17836,4727,6,4733,completed
4777,rigid,13103,17830,17841,4727,11,4738,completed
4778,rigid,13103,17830,17831,4727,1,4728,completed
4779,rigid,13103,17830,17831,4727,1,4728,completed
4780,rigid,13103,17830,17831,4727,1,4728,completed
4781,rigid,13103,17830,17836,4727,6,4733,completed
4782,rigid,13103,17830,17841,4727,11,4738,completed
4783,rigid,13103,17830,17831,4727,1,4728,completed
4784,rigid,13103,17830,17836,4727,6,4733,completed
4785,rigid,13103,17830,17841,4727,11,4738,completed
4786,rigid,13103,17830,17831,4727,1,4728,completed
4787,rigid,13103,17830,17831,4727,1,4728,completed
4788,rigid,13103,17830,17836,4727,6,4733,completed
4789,rigid,13103,17830,17836,4727,6,4733,completed
4790,rigid,13103,17830,17831,4727,1,4728,completed
4791,rigid,13103,17830,17841,4727,11,4738,completed
4792,rigid,13104,17830,17841,4726,11,4737,completed
4793,rigid,13104,17830,17831,4726,1,4727,completed
4794,rigid,13104,17830,17831,4726,1,4727,completed
4795,rigid,13104,17830,17840,4726,10,4736,completed
4796,rigid,13104,17830,17836,4726,6,4732,completed
4797,rigid,13104,17830,17831,4726,1,4727,completed
4798,rigid,13104,17830,17836,4726,6,4732,completed
4799,rigid,13104,17830,17841,4726,11,4737,completed
4800,rigid,13104,17830,17831,4726,1,4727,completed
4801,rigid,13104,17830,17836,4726,6,4732,completed
4802,rigid,13104,17830,17836,4726,6,4732,completed
4803,rigid,13104,17830,17831,4726,1,4727,completed
4804,rigid,13104,17830,17841,4726,11,4737,completed
4805,rigid,13104,17830,17841,4726,11,4737,completed
4806,rigid,13104,17830,17831,4726,1,4727,completed
4807,rigid,13104,17830,17836,4726,6,4732,completed
4808,rigid,13104,17830,17841,4726,11,4737,completed
4809,rigid,13104,17830,17831,4726,1,4727,completed
4810,rigid,13104,17830,17831,4726,1,4727,completed
4811,rigid,13104,17830,17836,4726,6,4732,completed
4812,rigid,13104,17830,17841,4726,11,4737,completed
4813,rigid,13104,17830,17831,4726,1,4727,completed
4814,rigid,13105,17830,17831,4725,1,4726,completed
4815,rigid,13105,17830,17831,4725,1,4726,completed
4816,rigid,13105,17830,17831,4725,1,4726,completed
4817,rigid,13105,17830,17831,4725,1,4726,completed
4818,rigid,13105,17830,17831,4725,1,4726,completed
4819,rigid,13105,17830,17831,4725,1,4726,completed
4820,rigid,13105,17830,17831,4725,1,4726,completed
4821,rigid,13105,17830,17831,4725,1,4726,completed
4822,rigid,13105,17830,17831,4725,1,4726,completed
4823,rigid,13105,17830,17831,4725,1,4726,completed
4824,rigid,13105,17830,17836,4725,6,4731,completed
4825,rigid,13106,17831,17832,4725,1,4726,completed
4826,rigid,13106,17831,17842,4725,11,4736,completed
4827,rigid,13106,17831,17832,4725,1,4726,completed
4828,rigid,13106,17831,17832,4725,1,4726,completed
4829,rigid,13106,17831,17832,4725,1,4726,completed
4830,rigid,13106,17831,17832,4725,1,4726,completed
4831,rigid,13106,17831,17837,4725,6,4731,completed
4832,rigid,13106,17831,17842,4725,11,4736,completed
4833,rigid,13106,17831,17837,4725,6,4731,completed
4834,rigid,13106,17831,17842,4725,11,4736,completed
4835,rigid,13106,17831,17832,4725,1,4726,completed
4836,rigid,13106,17831,17832,4725,1,4726,completed
4837,rigid,13106,17831,17842,4725,11,4736,completed
4838,rigid,13106,17831,17837,4725,6,4731,completed
4839,rigid,13106,17831,17832,4725,1,4726,completed
4840,rigid,13106,17831,17837,4725,6,4731,completed
4841,rigid,13106,17831,17842,4725,11,4736,completed
4842,rigid,13106,17831,17832,4725,1,4726,completed
4843,rigid,13106,17831,17832,4725,1,4726,completed
4844,rigid,13106,17831,17837,4725,6,4731,completed
4845,rigid,13106,17831,17832,4725,1,4726,completed
4846,rigid,13106,17831,17841,4725,10,4735,completed
4847,rigid,13107,17831,17832,4724,1,4725,completed
4848,rigid,13107,17831,17832,4724,1,4725,completed
4849,rigid,13107,17831,17832,4724,1,4725,completed
4850,rigid,13107,17831,17832,4724,1,4725,completed
4851,rigid,13107,17831,17832,4724,1,4725,completed
4852,rigid,13107,17831,17842,4724,11,4735,completed
4853,rigid,13107,17831,17837,4724,6,4730,completed
4854,rigid,13107,17831,17837,4724,6,4730,completed
4855,rigid,13107,17831,17832,4724,1,4725,completed
4856,rigid,13107,17831,17842,4724,11,4735,completed
4857,rigid,13107,17832,17833,4725,1,4726,completed
4858,rigid,13107,17832,17833,4725,1,4726,completed
4859,rigid,13108,17832,17833,4724,1,4725,completed
4860,rigid,13108,17832,17833,4724,1,4725,completed
4861,rigid,13108,17832,17838,4724,6,4730,completed
4862,rigid,13108,17832,17843,4724,11,4735,completed
4863,rigid,13108,17832,17838,4724,6,4730,completed
4864,rigid,13108,17832,17843,4724,11,4735,completed
4865,rigid,13108,17832,17998,4724,166,4890,completed
4866,rigid,13108,17832,17833,4724,1,4725,completed
4867,rigid,13108,17832,17833,4724,1,4725,completed
4868,rigid,13108,17832,17833,4724,1,4725,completed
4869,rigid,13108,17832,17833,4724,1,4725,completed
4870,rigid,13108,17832,17833,4724,1,4725,completed
4871,rigid,13108,17832,17838,4724,6,4730,completed
4872,rigid,13108,17832,17843,4724,11,4735,completed
4873,rigid,13108,17832,17833,4724,1,4725,completed
4874,rigid,13108,17832,17842,4724,10,4734,completed
4875,rigid,13108,17832,17838,4724,6,4730,completed
4876,rigid,13108,17832,17838,4724,6,4730,completed
4877,rigid,13108,17832,17833,4724,1,4725,completed
4878,rigid,13108,17832,17843,4724,11,4735,completed
4879,rigid,13108,17832,17833,4724,1,4725,completed
4880,rigid,13109,17832,17833,4723,1,4724,completed
4881,rigid,13109,17832,17833,4723,1,4724,completed
4882,rigid,13109,17832,17838,4723,6,4729,completed
4883,rigid,13109,17832,17838,4723,6,4729,completed
4884,rigid,13109,17832,17843,4723,11,4734,completed
4885,rigid,13109,17832,17842,4723,10,4733,completed
4886,rigid,13109,17832,17833,4723,1,4724,completed
4887,rigid,13109,17832,17833,4723,1,4724,completed
4888,rigid,13109,17832,17838,4723,6,4729,completed
4889,rigid,13109,17832,17842,4723,10,4733,completed
4890,rigid,13109,17832,17833,4723,1,4724,completed
4891,rigid,13109,17832,17833,4723,1,4724,completed
4892,rigid,13109,17832,17838,4723,6,4729,completed
4893,rigid,13109,17832,17841,4723,9,4732,completed
4894,rigid,13109,17832,17833,4723,1,4724,completed
4895,rigid,13109,17832,17838,4723,6,4729,completed
4896,rigid,13109,17832,17833,4723,1,4724,completed
4897,rigid,13109,17832,17843,4723,11,4734,completed
4898,rigid,13109,17832,17838,4723,6,4729,completed
4899,rigid,13110,17832,17843,4722,11,4733,completed
4900,rigid,13110,17832,17838,4722,6,4728,completed
4901,rigid,13110,17833,17834,4723,1,4724,completed
4902,rigid,13110,17833,17844,4723,11,4734,completed
4903,rigid,13110,17833,17844,4723,11,4734,completed
4904,rigid,13110,17833,17839,4723,6,4729,completed
4905,rigid,13110,17833,17834,4723,1,4724,completed
4906,rigid,13110,17833,17834,4723,1,4724,completed
4907,rigid,13110,17833,17834,4723,1,4724,completed
4908,rigid,13110,17833,17839,4723,6,4729,completed
4909,rigid,13110,17833,17839,4723,6,4729,completed
4910,rigid,13110,17833,17843,4723,10,4733,completed
4911,rigid,13110,17833,17843,4723,10,4733,completed
4912,rigid,13110,17833,17834,4723,1,4724,completed
4913,rigid,13110,17833,17834,4723,1,4724,completed
4914,rigid,13110,17833,17844,4723,11,4734,completed
4915,rigid,13110,17833,17839,4723,6,4729,completed
4916,rigid,13110,17833,17834,4723,1,4724,completed
4917,rigid,13110,17833,17839,4723,6,4729,completed
4918,rigid,13110,17833,17844,4723,11,4734,completed
4919,rigid,13111,17833,17838,4722,5,4727,completed
4920,rigid,13111,17833,17834,4722,1,4723,completed
4921,rigid,13111,17833,17846,4722,13,4735,completed
4922,rigid,13111,17833,17834,4722,1,4723,completed
4923,rigid,13111,17833,17834,4722,1,4723,completed
4924,rigid,13111,17833,17834,4722,1,4723,completed
4925,rigid,13111,17833,17834,4722,1,4723,completed
4926,rigid,13111,17833,17834,4722,1,4723,completed
4927,rigid,13111,17833,17834,4722,1,4723,completed
4928,rigid,13111,17833,17839,4722,6,4728,completed
4929,rigid,13111,17833,17844,4722,11,4733,completed
4930,rigid,13111,17833,17834,4722,1,4723,completed
4931,rigid,13111,17833,17846,4722,13,4735,completed
4932,rigid,13112,17833,17839,4721,6,4727,completed
4933,rigid,13112,17833,17834,4721,1,4722,completed
4934,rigid,13112,17833,17834,4721,1,4722,completed
4935,rigid,13112,17833,17839,4721,6,4727,completed
4936,rigid,13112,17833,17834,4721,1,4722,completed
4937,rigid,13112,17833,17844,4721,11,4732,completed
4938,rigid,13112,17833,17839,4721,6,4727,completed
4939,rigid,13112,17833,17843,4721,10,4731,completed
4940,rigid,13112,17833,17834,4721,1,4722,completed
4941,rigid,13112,17833,17839,4721,6,4727,completed
4942,rigid,13112,17833,17844,4721,11,4732,completed
4943,rigid,13112,17833,17834,4721,1,4722,completed
4944,rigid,13112,17833,17844,4721,11,4732,completed
4945,rigid,13112,17833,17839,4721,6,4727,completed
4946,rigid,13112,17833,17834,4721,1,4722,completed
4947,rigid,13112,17833,17834,4721,1,4722,completed
4948,rigid,13113,17833,17834,4720,1,4721,completed
4949,rigid,13113,17833,17838,4720,5,4725,completed
4950,rigid,13113,17833,17843,4720,10,4730,completed
4951,rigid,13113,17833,17834,4720,1,4721,completed
4952,rigid,13113,17834,17835,4721,1,4722,completed
4953,rigid,13113,17834,17843,4721,9,4730,completed
4954,rigid,13113,17834,17839,4721,5,4726,completed
4955,rigid,13113,17834,17835,4721,1,4722,completed
4956,rigid,13113,17834,17835,4721,1,4722,completed
4957,rigid,13113,17834,17835,4721,1,4722,completed
4958,rigid,13113,17834,17835,4721,1,4722,completed
4959,rigid,13113,17834,17835,4721,1,4722,completed
4960,rigid,13113,17834,17835,4721,1,4722,completed
4961,rigid,13113,17834,17835,4721,1,4722,completed
4962,rigid,13113,17834,17835,4721,1,4722,completed
4963,rigid,13113,17834,17835,4721,1,4722,completed
4964,rigid,13113,17834,17839,4721,5,4726,completed
4965,rigid,13113,17834,17845,4721,11,4732,completed
4966,rigid,13113,17834,17835,4721,1,4722,completed
4967,rigid,13113,17834,17835,4721,1,4722,completed
4968,rigid,13113,17834,17845,4721,11,4732,completed
4969,rigid,13113,17834,17840,4721,6,4727,completed
4970,rigid,13113,17834,17835,4721,1,4722,completed
4971,rigid,13114,17834,17835,4720,1,4721,completed
4972,rigid,13114,17834,17839,4720,5,4725,completed
4973,rigid,13114,17834,17845,4720,11,4731,completed
4974,rigid,13114,17834,17835,4720,1,4721,completed
4975,rigid,13114,17834,17835,4720,1,4721,completed
4976,rigid,13114,17834,17845,4720,11,4731,completed
4977,rigid,13114,17834,17840,4720,6,4726,completed
4978,rigid,13114,17834,17835,4720,1,4721,completed
4979,rigid,13114,17834,17835,4720,1,4721,completed
4980,rigid,13114,17834,17835,4720,1,4721,completed
4981,rigid,13114,17834,17845,4720,11,4731,completed
4982,rigid,13114,17834,17839,4720,5,4725,completed
4983,rigid,13114,17834,17835,4720,1,4721,completed
4984,rigid,13114,17834,17835,4720,1,4721,completed
4985,rigid,13114,17834,17845,4720,11,4731,completed
4986,rigid,13114,17834,17839,4720,5,4725,completed
4987,rigid,13114,17834,17835,4720,1,4721,completed
4988,rigid,13114,17834,17835,4720,1,4721,completed
4989,rigid,13115,17834,17845,4719,11,4730,completed
4990,rigid,13115,17834,17839,4719,5,4724,completed
4991,rigid,13115,17834,17835,4719,1,4720,completed
4992,rigid,13115,17834,17835,4719,1,4720,completed
4993,rigid,13115,17834,17847,4719,13,4732,completed
4994,rigid,13115,17834,17840,4719,6,4725,completed
4995,rigid,13115,17834,17835,4719,1,4720,completed
4996,rigid,13115,17834,17839,4719,5,4724,completed
4997,rigid,13115,17834,17845,4719,11,4730,completed
4998,rigid,13115,17834,17835,4719,1,4720,completed
4999,rigid,13115,17834,17839,4719,5,4724,completed
5000,rigid,13115,17834,17845,4719,11,4730,completed
5001,rigid,13115,17834,17845,4719,11,4730,completed
5002,rigid,13115,17834,17839,4719,5,4724,completed
5003,rigid,13115,17834,17835,4719,1,4720,completed
5004,rigid,13115,17834,17835,4719,1,4720,completed
5005,rigid,13115,17834,17844,4719,10,4729,completed
5006,rigid,13115,17834,17839,4719,5,4724,completed
5007,rigid,13115,17834,17835,4719,1,4720,completed
5008,rigid,13115,17834,17844,4719,10,4729,completed
5009,rigid,13115,17834,17839,4719,5,4724,completed
5010,rigid,13115,17834,17835,4719,1,4720,completed
5011,rigid,13115,17834,17840,4719,6,4725,completed
5012,rigid,13115,17834,17844,4719,10,4729,completed
5013,rigid,13115,17834,17844,4719,10,4729,completed
5014,rigid,13116,17834,17839,4718,5,4723,completed
5015,rigid,13116,17834,17835,4718,1,4719,completed
5016,rigid,13116,17834,17835,4718,1,4719,completed
5017,rigid,13116,17835,17847,4719,12,4731,completed
5018,rigid,13116,17835,17840,4719,5,4724,completed
5019,rigid,13116,17835,17836,4719,1,4720,completed
5020,rigid,13116,17835,17836,4719,1,4720,completed
5021,rigid,13116,17835,17840,4719,5,4724,completed
5022,rigid,13116,17835,17840,4719,5,4724,completed
5023,rigid,13116,17835,17846,4719,11,4730,completed
5024,rigid,13116,17835,17846,4719,11,4730,completed
5025,rigid,13116,17835,17836,4719,1,4720,completed
5026,rigid,13116,17835,17836,4719,1,4720,completed
5027,rigid,13116,17835,17836,4719,1,4720,completed
5028,rigid,13116,17835,17836,4719,1,4720,completed
5029,rigid,13116,17835,17836,4719,1,4720,completed
5030,rigid,13116,17835,17836,4719,1,4720,completed
5031,rigid,13116,17835,17845,4719,10,4729,completed
5032,rigid,13117,17835,17840,4718,5,4723,completed
5033,rigid,13117,17835,17836,4718,1,4719,completed
5034,rigid,13117,17835,17840,4718,5,4723,completed
5035,rigid,13117,17835,17836,4718,1,4719,completed
5036,rigid,13117,17835,17845,4718,10,4728,completed
5037,rigid,13117,17835,17840,4718,5,4723,completed
5038,rigid,13117,17835,17845,4718,10,4728,completed
5039,rigid,13117,17835,17836,4718,1,4719,completed
5040,rigid,13117,17835,17840,4718,5,4723,completed
5041,rigid,13117,17835,17846,4718,11,4729,completed
5042,rigid,13117,17835,17836,4718,1,4719,completed
5043,rigid,13117,17835,17836,4718,1,4719,completed
5044,rigid,13117,17835,17840,4718,5,4723,completed
5045,rigid,13117,17835,17845,4718,10,4728,completed
5046,rigid,13117,17835,17836,4718,1,4719,completed
5047,rigid,13117,17835,17840,4718,5,4723,completed
5048,rigid,13117,17835,17845,4718,10,4728,completed
5049,rigid,13118,17835,17836,4717,1,4718,completed
5050,rigid,13118,17835,17840,4717,5,4722,completed
5051,rigid,13118,17835,17846,4717,11,4728,completed
5052,rigid,13118,17835,17840,4717,5,4722,completed
5053,rigid,13118,17835,17836,4717,1,4718,completed
5054,rigid,13118,17835,17846,4717,11,4728,completed
5055,rigid,13118,17835,17836,4717,1,4718,completed
5056,rigid,13118,17835,17836,4717,1,4718,completed
5057,rigid,13118,17835,17836,4717,1,4718,completed
5058,rigid,13118,17835,17836,4717,1,4718,completed
5059,rigid,13118,17835,17836,4717,1,4718,completed
5060,rigid,13118,17835,17836,4717,1,4718,completed
5061,rigid,13118,17835,17836,4717,1,4718,completed
5062,rigid,13118,17835,17840,4717,5,4722,completed
5063,rigid,13118,17835,17845,4717,10,4727,completed
5064,rigid,13118,17835,17840,4717,5,4722,completed
5065,rigid,13118,17835,17846,4717,11,4728,completed
5066,rigid,13119,17835,17836,4716,1,4717,completed
5067,rigid,13119,17835,17836,4716,1,4717,completed
5068,rigid,13119,17835,17836,4716,1,4717,completed
5069,rigid,13119,17835,17836,4716,1,4717,completed
5070,rigid,13119,17835,17836,4716,1,4717,completed
5071,rigid,13119,17835,17836,4716,1,4717,completed
5072,rigid,13119,17835,17836,4716,1,4717,completed
5073,rigid,13119,17835,17836,4716,1,4717,completed
5074,rigid,13119,17835,17840,4716,5,4721,completed
5075,rigid,13119,17835,17846,4716,11,4727,completed
5076,rigid,13119,17837,17908,4718,71,4789,completed
5077,rigid,13119,17837,17847,4718,10,4728,completed
5078,rigid,13119,17838,17843,4719,5,4724,completed
5079,rigid,13119,17838,17839,4719,1,4720,completed
5080,rigid,13120,17838,17839,4718,1,4719,completed
5081,rigid,13120,17838,17843,4718,5,4723,completed
5082,rigid,13120,17838,17849,4718,11,4729,completed
5083,rigid,13120,17838,17839,4718,1,4719,completed
5084,rigid,13120,17838,17843,4718,5,4723,completed
5085,rigid,13120,17838,17849,4718,11,4729,completed
5086,rigid,13120,17838,17839,4718,1,4719,completed
5087,rigid,13120,17838,17839,4718,1,4719,completed
5088,rigid,13120,17838,17843,4718,5,4723,completed
5089,rigid,13120,17838,17843,4718,5,4723,completed
5090,rigid,13120,17838,17848,4718,10,4728,completed
5091,rigid,13120,17838,17848,4718,10,4728,completed
5092,rigid,13120,17838,17839,4718,1,4719,completed
5093,rigid,13120,17838,17839,4718,1,4719,completed
5094,rigid,13120,17838,17839,4718,1,4719,completed
5095,rigid,13120,17838,17839,4718,1,4719,completed
5096,rigid,13120,17838,17843,4718,5,4723,completed
5097,rigid,13120,17838,17843,4718,5,4723,completed
5098,rigid,13120,17838,17849,4718,11,4729,completed
5099,rigid,13120,17838,17849,4718,11,4729,completed
5100,rigid,13120,17838,17839,4718,1,4719,completed
5101,rigid,13120,17838,17839,4718,1,4719,completed
5102,rigid,13120,17838,17843,4718,5,4723,completed
5103,rigid,13120,17838,17839,4718,1,4719,completed
5104,rigid,13120,17838,17849,4718,11,4729,completed
5105,rigid,13120,17838,17839,4718,1,4719,completed
5106,rigid,13121,17838,17843,4717,5,4722,completed
5107,rigid,13121,17838,17849,4717,11,4728,completed
5108,rigid,13121,17838,17843,4717,5,4722,completed
5109,rigid,13121,17838,17849,4717,11,4728,completed
5110,rigid,13121,17838,17839,4717,1,4718,completed
5111,rigid,13121,17838,17843,4717,5,4722,completed
5112,rigid,13121,17838,17843,4717,5,4722,completed
5113,rigid,13121,17838,17839,4717,1,4718,completed
5114,rigid,13121,17838,17849,4717,11,4728,completed
5115,rigid,13121,17838,17839,4717,1,4718,completed
5116,rigid,13121,17838,17848,4717,10,4727,completed
5117,rigid,13121,17838,17839,4717,1,4718,completed
5118,rigid,13121,17838,17848,4717,10,4727,completed
5119,rigid,13121,17838,17843,4717,5,4722,completed
5120,rigid,13121,17838,17839,4717,1,4718,completed
5121,rigid,13121,17838,17839,4717,1,4718,completed
5122,rigid,13121,17838,17839,4717,1,4718,completed
5123,rigid,13121,17838,17839,4717,1,4718,completed
5124,rigid,13121,17838,17839,4717,1,4718,completed
5125,rigid,13121,17838,17839,4717,1,4718,completed
5126,rigid,13121,17838,17839,4717,1,4718,completed
5127,rigid,13122,17838,17839,4716,1,4717,completed
5128,rigid,13122,17838,17839,4716,1,4717,completed
5129,rigid,13122,17838,17842,4716,4,4720,completed
5130,rigid,13122,17838,17848,4716,10,4726,completed
5131,rigid,13122,17838,17842,4716,4,4720,completed
5132,rigid,13122,17838,17839,4716,1,4717,completed
5133,rigid,13122,17839,17849,4717,10,4727,completed
5134,rigid,13122,17839,17840,4717,1,4718,completed
5135,rigid,13122,17839,17849,4717,10,4727,completed
5136,rigid,13122,17839,17843,4717,4,4721,completed
5137,rigid,13122,17839,17840,4717,1,4718,completed
5138,rigid,13122,17839,17849,4717,10,4727,completed
5139,rigid,13123,17839,17843,4716,4,4720,completed
5140,rigid,13123,17839,17849,4716,10,4726,completed
5141,rigid,13123,17839,17843,4716,4,4720,completed
5142,rigid,13123,17839,17840,4716,1,4717,completed
5143,rigid,13123,17839,17840,4716,1,4717,completed
5144,rigid,13123,17839,17843,4716,4,4720,completed
5145,rigid,13123,17839,17851,4716,12,4728,completed
5146,rigid,13123,17839,17840,4716,1,4717,completed
5147,rigid,13123,17839,17843,4716,4,4720,completed
5148,rigid,13123,17839,17843,4716,4,4720,completed
5149,rigid,13123,17839,17840,4716,1,4717,completed
5150,rigid,13123,17839,17849,4716,10,4726,completed
5151,rigid,13123,17839,17849,4716,10,4726,completed
5152,rigid,13123,17839,17840,4716,1,4717,completed
5153,rigid,13123,17839,17843,4716,4,4720,completed
5154,rigid,13123,17839,17849,4716,10,4726,completed
5155,rigid,13123,17839,17840,4716,1,4717,completed
5156,rigid,13123,17839,17843,4716,4,4720,completed
5157,rigid,13123,17839,17850,4716,11,4727,completed
5158,rigid,13123,17839,17840,4716,1,4717,completed
5159,rigid,13123,17839,17840,4716,1,4717,completed
5160,rigid,13123,17839,17840,4716,1,4717,completed
5161,rigid,13123,17839,17840,4716,1,4717,completed
5162,rigid,13123,17839,17840,4716,1,4717,completed
5163,rigid,13123,17839,17851,4716,12,4728,completed
5164,rigid,13124,17839,17843,4715,4,4719,completed
5165,rigid,13124,17839,17840,4715,1,4716,completed
5166,rigid,13124,17839,17843,4715,4,4719,completed
5167,rigid,13124,17839,17849,4715,10,4725,completed
5168,rigid,13124,17839,17840,4715,1,4716,completed
5169,rigid,13124,17839,17840,4715,1,4716,completed
5170,rigid,13124,17839,17843,4715,4,4719,completed
5171,rigid,13124,17839,17849,4715,10,4725,completed
5172,rigid,13124,17839,17840,4715,1,4716,completed
5173,rigid,13124,17839,17840,4715,1,4716,completed
5174,rigid,13124,17839,17843,4715,4,4719,completed
5175,rigid,13124,17839,17849,4715,10,4725,completed
5176,rigid,13124,17839,17840,4715,1,4716,completed
5177,rigid,13124,17839,17840,4715,1,4716,completed
5178,rigid,13124,17839,17843,4715,4,4719,completed
5179,rigid,13124,17839,17840,4715,1,4716,completed
5180,rigid,13124,17839,17849,4715,10,4725,completed
5181,rigid,13125,17839,17840,4714,1,4715,completed
5182,rigid,13125,17839,17849,4714,10,4724,completed
5183,rigid,13125,17839,17843,4714,4,4718,completed
5184,rigid,13125,17839,17843,4714,4,4718,completed
5185,rigid,13125,17839,17849,4714,10,4724,completed
5186,rigid,13125,17840,17841,4715,1,4716,completed
5187,rigid,13125,17840,17841,4715,1,4716,completed
5188,rigid,13125,17840,17850,4715,10,4725,completed
5189,rigid,13125,17840,17844,4715,4,4719,completed
5190,rigid,13125,17840,17841,4715,1,4716,completed
5191,rigid,13125,17840,17841,4715,1,4716,completed
5192,rigid,13125,17840,17841,4715,1,4716,completed
5193,rigid,13125,17840,17841,4715,1,4716,completed
5194,rigid,13125,17840,17841,4715,1,4716,completed
5195,rigid,13125,17840,17841,4715,1,4716,completed
5196,rigid,13125,17840,17841,4715,1,4716,completed
5197,rigid,13125,17840,17841,4715,1,4716,completed
5198,rigid,13125,17840,17841,4715,1,4716,completed
5199,rigid,13126,17840,17844,4714,4,4718,completed
5200,rigid,13126,17840,17850,4714,10,4724,completed
5201,rigid,13126,17840,17850,4714,10,4724,completed
5202,rigid,13126,17840,17844,4714,4,4718,completed
5203,rigid,13126,17840,17841,4714,1,4715,completed
5204,rigid,13126,17840,17841,4714,1,4715,completed
5205,rigid,13126,17840,17844,4714,4,4718,completed
5206,rigid,13126,17840,17850,4714,10,4724,completed
5207,rigid,13126,17840,17841,4714,1,4715,completed
5208,rigid,13126,17840,17841,4714,1,4715,completed
5209,rigid,13126,17840,17843,4714,3,4717,completed
5210,rigid,13126,17840,17841,4714,1,4715,completed
5211,rigid,13126,17840,17850,4714,10,4724,completed
5212,rigid,13126,17840,17841,4714,1,4715,completed
5213,rigid,13126,17840,17841,4714,1,4715,completed
5214,rigid,13126,17840,17844,4714,4,4718,completed
5215,rigid,13126,17840,17841,4714,1,4715,completed
5216,rigid,13126,17840,17850,4714,10,4724,completed
5217,rigid,13126,17840,17850,4714,10,4724,completed
5218,rigid,13126,17840,17844,4714,4,4718,completed
5219,rigid,13126,17840,17841,4714,1,4715,completed
5220,rigid,13126,17840,17841,4714,1,4715,completed
5221,rigid,13126,17840,17843,4714,3,4717,completed
5222,rigid,13126,17840,17850,4714,10,4724,completed
5223,rigid,13126,17840,17850,4714,10,4724,completed
5224,rigid,13127,17840,17843,4713,3,4716,completed
5225,rigid,13127,17840,17841,4713,1,4714,completed
5226,rigid,13127,17840,17850,4713,10,4723,completed
5227,rigid,13127,17840,17843,4713,3,4716,completed
5228,rigid,13127,17840,17841,4713,1,4714,completed
5229,rigid,13127,17840,17841,4713,1,4714,completed
5230,rigid,13127,17840,17841,4713,1,4714,completed
5231,rigid,13127,17840,17851,4713,11,4724,completed
5232,rigid,13127,17840,17843,4713,3,4716,completed
5233,rigid,13127,17840,17841,4713,1,4714,completed
5234,rigid,13127,17840,17841,4713,1,4714,completed
5235,rigid,13127,17840,17850,4713,10,4723,completed
5236,rigid,13127,17840,17843,4713,3,4716,completed
5237,rigid,13127,17840,17841,4713,1,4714,completed
5238,rigid,13127,17840,17843,4713,3,4716,completed
5239,rigid,13127,17840,17850,4713,10,4723,completed
5240,rigid,13127,17840,17841,4713,1,4714,completed
5241,rigid,13127,17840,17849,4713,9,4722,completed
5242,rigid,13127,17840,17843,4713,3,4716,completed
5243,rigid,13127,17840,17843,4713,3,4716,completed
5244,rigid,13127,17840,17850,4713,10,4723,completed
5245,rigid,13128,17840,17842,4712,2,4714,completed
5246,rigid,13128,17840,17850,4712,10,4722,completed
5247,rigid,13128,17841,17884,4713,43,4756,completed
5248,rigid,13128,17841,17843,4713,2,4715,completed
5249,rigid,13128,17841,17851,4713,10,4723,completed
5250,rigid,13128,17841,17843,4713,2,4715,completed
5251,rigid,13128,17841,17843,4713,2,4715,completed
5252,rigid,13128,17841,17851,4713,10,4723,completed
5253,rigid,13128,17841,17851,4713,10,4723,completed
5254,rigid,13128,17841,17851,4713,10,4723,completed
5255,rigid,13128,17841,17843,4713,2,4715,completed
5256,rigid,13128,17841,17850,4713,9,4722,completed
5257,rigid,13128,17841,17843,4713,2,4715,completed
5258,rigid,13128,17841,17843,4713,2,4715,completed
5259,rigid,13128,17841,17850,4713,9,4722,completed
5260,rigid,13128,17841,17850,4713,9,4722,completed
5261,rigid,13129,17841,17842,4712,1,4713,completed
5262,rigid,13139,17841,18030,4702,189,4891,completed
5263,rigid,13143,17846,17859,4703,13,4716,completed
5264,rigid,13144,17852,17857,4708,5,4713,completed
5265,rigid,13151,17854,17963,4703,109,4812,completed
5266,rigid,13168,17857,17858,4689,1,4690,completed
5267,rigid,13169,17857,17879,4688,22,4710,completed
5268,rigid,13169,17858,17930,4689,72,4761,completed
5269,rigid,13171,17858,17865,4687,7,4694,completed
5270,rigid,13180,17859,17872,4679,13,4692,completed
5271,rigid,13222,17859,17860,4637,1,4638,completed
5272,rigid,13222,17859,17861,4637,2,4639,completed
5273,rigid,13222,17859,17862,4637,3,4640,completed
5274,rigid,13222,17859,17872,4637,13,4650,completed
5275,rigid,13222,17859,17891,4637,32,4669,completed
5276,rigid,13231,17859,17862,4628,3,4631,completed
5277,rigid,13231,17859,17860,4628,1,4629,completed
5278,rigid,13231,17859,17861,4628,2,4630,completed
5279,rigid,13231,17859,17871,4628,12,4640,completed
5280,rigid,13231,17859,17889,4628,30,4658,completed
5281,rigid,13251,17865,18560,4614,695,5309,completed
5282,rigid,13252,17869,18298,4617,429,5046,completed
5283,rigid,13256,17869,17870,4613,1,4614,completed
5284,rigid,13256,17869,17871,4613,2,4615,completed
5285,rigid,13256,17869,17873,4613,4,4617,completed
5286,rigid,13256,17869,17881,4613,12,4625,completed
5287,rigid,13256,17869,17905,4613,36,4649,completed
5288,rigid,13266,17869,17870,4603,1,4604,completed
5289,rigid,13266,17869,17871,4603,2,4605,completed
5290,rigid,13266,17869,17873,4603,4,4607,completed
5291,rigid,13266,17869,17881,4603,12,4615,completed
5292,rigid,13266,17869,17905,4603,36,4639,completed
5293,rigid,13269,17869,17932,4600,63,4663,completed
5294,rigid,13274,17869,17871,4595,2,4597,completed
5295,rigid,13274,17869,17872,4595,3,4598,completed
5296,rigid,13274,17869,17873,4595,4,4599,completed
5297,rigid,13274,17869,17887,4595,18,4613,completed
5298,rigid,13274,17869,17909,4595,40,4635,completed
5299,rigid,13287,17869,17930,4582,61,4643,completed
5300,rigid,13311,17869,17925,4558,56,4614,completed
5301,rigid,13329,17869,17871,4540,2,4542,completed
5302,rigid,13329,17869,17896,4540,27,4567,completed
5303,rigid,13329,17869,17922,4540,53,4593,completed
5304,rigid,13329,17869,17872,4540,3,4543,completed
5305,rigid,13329,17869,17875,4540,6,4546,completed
5306,rigid,13333,17869,18059,4536,190,4726,completed
5307,rigid,13349,17871,18060,4522,189,4711,completed
5308,rigid,13368,17871,18032,4503,161,4664,completed
5309,rigid,13382,17871,17872,4489,1,4490,completed
5310,rigid,13487,17895,17899,4408,4,4412,completed
5311,rigid,13494,17898,18557,4404,659,5063,completed
5312,rigid,13494,17899,18556,4405,657,5062,completed
5313,rigid,13506,17899,18557,4393,658,5051,completed
5314,rigid,13506,17899,18552,4393,653,5046,completed
5315,rigid,13513,17899,18555,4386,656,5042,completed
5316,rigid,13520,17899,18550,4379,651,5030,completed
5317,rigid,13520,17899,18247,4379,348,4727,completed
5318,rigid,13524,17899,17917,4375,18,4393,completed
5319,rigid,13524,17899,17902,4375,3,4378,completed
5320,rigid,13524,17899,17903,4375,4,4379,completed
5321,rigid,13524,17899,17903,4375,4,4379,completed
5322,rigid,13524,17899,17972,4375,73,4448,completed
5323,rigid,13529,17899,17902,4370,3,4373,completed
5324,rigid,13529,17899,17903,4370,4,4374,completed
5325,rigid,13529,17899,17903,4370,4,4374,completed
5326,rigid,13529,17899,17956,4370,57,4427,completed
5327,rigid,13529,17899,17919,4370,20,4390,completed
5328,rigid,13538,17899,17902,4361,3,4364,completed
5329,rigid,13539,17899,17903,4360,4,4364,completed
5330,rigid,13539,17899,17904,4360,5,4365,completed
5331,rigid,13539,17899,17960,4360,61,4421,completed
5332,rigid,13539,17899,17922,4360,23,4383,completed
5333,rigid,13539,17899,18014,4360,115,4475,completed
5334,rigid,13545,17901,18571,4356,670,5026,completed
5335,rigid,13545,17901,18387,4356,486,4842,completed
5336,rigid,13553,17908,18702,4355,794,5149,completed
5337,rigid,13555,17912,18561,4357,649,5006,completed
5338,rigid,13561,17922,18566,4361,644,5005,completed
5339,rigid,13565,17930,18587,4365,657,5022,completed
5340,rigid,13587,17930,17931,4343,1,4344,completed
5341,rigid,13597,17930,18026,4333,96,4429,completed
5342,rigid,13598,17930,17931,4332,1,4333,completed
5343,rigid,13601,17930,17931,4329,1,4330,completed
5344,rigid,13602,17930,17931,4328,1,4329,completed
5345,rigid,13604,17930,17970,4326,40,4366,completed
5346,rigid,13606,17931,17950,4325,19,4344,completed
5347,rigid,13612,17942,20835,4330,2893,7223,completed
5348,rigid,13624,17947,17951,4323,4,4327,completed
5349,rigid,13624,17947,17952,4323,5,4328,completed
5350,rigid,13624,17947,17952,4323,5,4328,completed
5351,rigid,13624,17947,17988,4323,41,4364,completed
5352,rigid,13624,17950,18062,4326,112,4438,completed
5353,rigid,13624,17951,17955,4327,4,4331,completed
5354,rigid,13624,17952,18061,4328,109,4437,completed
5355,rigid,13624,17952,18082,4328,130,4458,completed
5356,rigid,13624,17955,17961,4331,6,4337,completed
5357,rigid,13624,17961,18099,4337,138,4475,completed
5358,rigid,13624,17963,17976,4339,13,4352,completed
5359,rigid,13624,17963,18091,4339,128,4467,completed
5360,rigid,13624,17963,18101,4339,138,4477,completed
5361,rigid,13624,17963,18025,4339,62,4401,completed
5362,rigid,13624,17963,17967,4339,4,4343,completed
5363,rigid,13631,17963,17984,4332,21,4353,completed
5364,rigid,13636,17963,17964,4327,1,4328,completed
5365,rigid,13639,17970,17976,4331,6,4337,completed
5366,rigid,13646,17976,17982,4330,6,4336,completed
5367,rigid,13646,17976,18529,4330,553,4883,completed
5368,rigid,13647,17992,18004,4345,12,4357,completed
5369,rigid,13647,17999,18020,4352,21,4373,completed
5370,rigid,13654,17999,18002,4345,3,4348,completed
5371,rigid,13654,17999,18003,4345,4,4349,completed
5372,rigid,13654,17999,18004,4345,5,4350,completed
5373,rigid,13654,17999,18004,4345,5,4350,completed
5374,rigid,13655,18002,18035,4347,33,4380,completed
5375,rigid,13657,18003,18005,4346,2,4348,completed
5376,rigid,13660,18032,18139,4372,107,4479,completed
5377,rigid,13663,18032,18065,4369,33,4402,completed
5378,rigid,13666,18054,19782,4388,1728,6116,completed
5379,rigid,13667,18054,19124,4387,1070,5457,completed
5380,rigid,13669,18061,19789,4392,1728,6120,completed
5381,rigid,13670,18082,18083,4412,1,4413,completed
5382,rigid,13670,18083,19811,4413,1728,6141,completed
5383,rigid,13671,18099,18100,4428,1,4429,completed
5384,rigid,13671,18099,19166,4428,1067,5495,completed
5385,rigid,13671,18100,18676,4429,576,5005,completed
5386,rigid,13671,18100,18676,4429,576,5005,completed
5387,rigid,13673,18110,18116,4437,6,4443,completed
5388,rigid,13673,18110,18830,4437,720,5157,completed
5389,rigid,13673,18110,18830,4437,720,5157,completed
5390,rigid,13674,18110,18974,4436,864,5300,completed
5391,rigid,13674,18116,18980,4442,864,5306,completed
5392,rigid,13674,18116,19180,4442,1064,5506,completed
5393,rigid,13674,18129,19857,4455,1728,6183,completed
5394,rigid,13674,18129,19857,4455,1728,6183,completed
5395,rigid,13674,18129,19857,4455,1728,6183,completed
5396,rigid,13675,18129,19857,4454,1728,6182,completed
5397,rigid,13675,18129,19857,4454,1728,6182,completed
5398,rigid,13675,18129,19857,4454,1728,6182,completed
5399,rigid,13675,18129,18979,4454,850,5304,completed
5400,rigid,13675,18129,19857,4454,1728,6182,completed
5401,rigid,13676,18136,19864,4460,1728,6188,completed
5402,rigid,13676,18136,19864,4460,1728,6188,completed
5403,rigid,13676,18136,19864,4460,1728,6188,completed
5404,rigid,13676,18139,19867,4463,1728,6191,completed
5405,rigid,13676,18139,19867,4463,1728,6191,completed
5406,rigid,13676,18139,19867,4463,1728,6191,completed
5407,rigid,13681,18139,18140,4458,1,4459,completed
5408,rigid,13683,18139,18147,4456,8,4464,completed
5409,rigid,13699,18139,18244,4440,105,4545,completed
5410,rigid,13699,18139,18190,4440,51,4491,completed
5411,rigid,13699,18139,18202,4440,63,4503,completed
5412,rigid,13699,18139,18274,4440,135,4575,completed
5413,rigid,13699,18139,18270,4440,131,4571,completed
5414,rigid,13699,18139,18293,4440,154,4594,completed
5415,rigid,13699,18139,18227,4440,88,4528,completed
5416,rigid,13699,18139,18200,4440,61,4501,completed
5417,rigid,13699,18139,18180,4440,41,4481,completed
5418,rigid,13699,18139,18161,4440,22,4462,completed
5419,rigid,13706,18139,18161,4433,22,4455,completed
5420,rigid,13707,18139,18145,4432,6,4438,completed
5421,rigid,13712,18139,18185,4427,46,4473,completed
5422,rigid,13712,18139,18185,4427,46,4473,completed
5423,rigid,13712,18139,18185,4427,46,4473,completed
5424,rigid,13712,18139,18185,4427,46,4473,completed
5425,rigid,13712,18139,18185,4427,46,4473,completed
5426,rigid,13712,18140,18186,4428,46,4474,completed
5427,rigid,13712,18140,18186,4428,46,4474,completed
5428,rigid,13712,18140,18186,4428,46,4474,completed
5429,rigid,13712,18140,18186,4428,46,4474,completed
5430,rigid,13713,18140,18186,4427,46,4473,completed
5431,rigid,13713,18145,18191,4432,46,4478,completed
5432,rigid,13713,18145,18191,4432,46,4478,completed
5433,rigid,13728,18147,18180,4419,33,4452,completed
5434,rigid,13728,18150,18151,4422,1,4423,completed
5435,rigid,13731,18150,19860,4419,1710,6129,completed
5436,rigid,13744,18151,18513,4407,362,4769,completed
5437,rigid,13750,18151,18155,4401,4,4405,completed
5438,rigid,13755,18151,18158,4396,7,4403,completed
5439,rigid,13755,18153,18160,4398,7,4405,completed
5440,rigid,13755,18153,18160,4398,7,4405,completed
5441,rigid,13755,18153,18160,4398,7,4405,completed
5442,rigid,13755,18153,18160,4398,7,4405,completed
5443,rigid,13755,18155,18162,4400,7,4407,completed
5444,rigid,13755,18157,18164,4402,7,4409,completed
5445,rigid,13755,18157,18164,4402,7,4409,completed
5446,rigid,13755,18157,18164,4402,7,4409,completed
5447,rigid,13755,18157,18164,4402,7,4409,completed
5448,rigid,13755,18158,18165,4403,7,4410,completed
5449,rigid,13755,18160,18167,4405,7,4412,completed
5450,rigid,13755,18160,18167,4405,7,4412,completed
5451,rigid,13755,18160,18167,4405,7,4412,completed
5452,rigid,13755,18160,18167,4405,7,4412,completed
5453,rigid,13756,18161,18187,4405,26,4431,completed
5454,rigid,13760,18161,18525,4401,364,4765,completed
5455,rigid,13760,18161,18521,4401,360,4761,completed
5456,rigid,13760,18161,18525,4401,364,4765,completed
5457,rigid,13760,18161,18523,4401,362,4763,completed
5458,rigid,13761,18162,18526,4401,364,4765,completed
5459,rigid,13761,18164,18523,4403,359,4762,completed
5460,rigid,13761,18164,18528,4403,364,4767,completed
5461,rigid,13761,18164,18527,4403,363,4766,completed
5462,rigid,13761,18164,18527,4403,363,4766,completed
5463,rigid,13762,18165,18529,4403,364,4767,completed
5464,rigid,13762,18167,18534,4405,367,4772,completed
5465,rigid,13763,18167,18528,4404,361,4765,completed
5466,rigid,13764,18167,18182,4403,15,4418,completed
5467,rigid,13764,18167,18170,4403,3,4406,completed
5468,rigid,13764,18170,18172,4406,2,4408,completed
5469,rigid,13764,18172,18173,4408,1,4409,completed
5470,rigid,13764,18173,18176,4409,3,4412,completed
5471,rigid,13764,18173,18177,4409,4,4413,completed
5472,rigid,13764,18173,18176,4409,3,4412,completed
5473,rigid,13764,18173,18175,4409,2,4411,completed
5474,rigid,13764,18173,18176,4409,3,4412,completed
5475,rigid,13764,18175,18177,4411,2,4413,completed
5476,rigid,13765,18176,18188,4411,12,4423,completed
5477,rigid,13770,18177,18293,4407,116,4523,completed
5478,rigid,13770,18177,18247,4407,70,4477,completed
5479,rigid,13770,18180,18270,4410,90,4500,completed
5480,rigid,13770,18185,18244,4415,59,4474,completed
5481,rigid,13770,18185,18247,4415,62,4477,completed
5482,rigid,13771,18186,18305,4415,119,4534,completed
5483,rigid,13772,18190,18199,4418,9,4427,completed
5484,rigid,13776,18190,18305,4414,115,4529,completed
5485,rigid,13777,18190,18224,4413,34,4447,completed
5486,rigid,13785,18190,18198,4405,8,4413,completed
5487,rigid,13785,18190,18198,4405,8,4413,completed
5488,rigid,13785,18191,18192,4406,1,4407,completed
5489,rigid,13785,18191,18192,4406,1,4407,completed
5490,rigid,13785,18192,18200,4407,8,4415,completed
5491,rigid,13785,18192,18200,4407,8,4415,completed
5492,rigid,13785,18194,18202,4409,8,4417,completed
5493,rigid,13785,18194,18202,4409,8,4417,completed
5494,rigid,13785,18194,18202,4409,8,4417,completed
5495,rigid,13785,18194,18202,4409,8,4417,completed
5496,rigid,13785,18198,18206,4413,8,4421,completed
5497,rigid,13785,18198,18206,4413,8,4421,completed
5498,rigid,13785,18199,18207,4414,8,4422,completed
5499,rigid,13785,18199,18200,4414,1,4415,completed
5500,rigid,13785,18199,18200,4414,1,4415,completed
5501,rigid,13792,18200,18281,4408,81,4489,completed
5502,rigid,13793,18200,19902,4407,1702,6109,completed
5503,rigid,13793,18200,18626,4407,426,4833,completed
5504,rigid,13793,18201,18632,4408,431,4839,completed
5505,rigid,13794,18201,18234,4407,33,4440,completed
5506,rigid,13796,18201,18202,4405,1,4406,completed
5507,rigid,13796,18201,18203,4405,2,4407,completed
5508,rigid,13796,18201,18204,4405,3,4408,completed
5509,rigid,13796,18201,18202,4405,1,4406,completed
5510,rigid,13796,18202,18203,4406,1,4407,completed
5511,rigid,13796,18202,18203,4406,1,4407,completed
5512,rigid,13796,18202,18203,4406,1,4407,completed
5513,rigid,13796,18202,18203,4406,1,4407,completed
5514,rigid,13797,18202,18235,4405,33,4438,completed
5515,rigid,13801,18202,18253,4401,51,4452,completed
5516,rigid,13801,18202,18236,4401,34,4435,completed
5517,rigid,13801,18203,18237,4402,34,4436,completed
5518,rigid,13801,18203,18267,4402,64,4466,completed
5519,rigid,13801,18203,18246,4402,43,4445,completed
5520,rigid,13801,18203,18231,4402,28,4430,completed
5521,rigid,13801,18203,18278,4402,75,4477,completed
5522,rigid,13801,18204,18301,4403,97,4500,completed
5523,rigid,13801,18206,18304,4405,98,4503,completed
5524,rigid,13801,18206,18217,4405,11,4416,completed
5525,rigid,13801,18207,18214,4406,7,4413,completed
5526,rigid,13801,18207,18217,4406,10,4416,completed
5527,rigid,13801,18207,18221,4406,14,4420,completed
5528,rigid,13801,18207,18218,4406,11,4417,completed
5529,rigid,13801,18207,18229,4406,22,4428,completed
5530,rigid,13801,18211,18247,4410,36,4446,completed
5531,rigid,13806,18214,18215,4408,1,4409,completed
5532,rigid,13807,18214,18549,4407,335,4742,completed
5533,rigid,13807,18214,18548,4407,334,4741,completed
5534,rigid,13807,18214,18555,4407,341,4748,completed
5535,rigid,13807,18215,18559,4408,344,4752,completed
5536,rigid,13807,18215,18568,4408,353,4761,completed
5537,rigid,13807,18217,18564,4410,347,4757,completed
5538,rigid,13807,18217,18569,4410,352,4762,completed
5539,rigid,13807,18217,18219,4410,2,4412,completed
5540,rigid,13807,18218,18561,4411,343,4754,completed
5541,rigid,13807,18219,18560,4412,341,4753,completed
5542,rigid,13807,18221,18560,4414,339,4753,completed
5543,rigid,13807,18224,18226,4417,2,4419,completed
5544,rigid,13810,18237,18239,4427,2,4429,completed
5545,rigid,13814,18239,21839,4425,3600,8025,completed
5546,rigid,13814,18239,19103,4425,864,5289,completed
5547,rigid,13819,18239,18428,4420,189,4609,completed
5548,rigid,13819,18239,18438,4420,199,4619,completed
5549,rigid,13820,18239,18419,4419,180,4599,completed
5550,rigid,13821,18239,18837,4418,598,5016,completed
5551,rigid,13825,18239,21695,4414,3456,7870,completed
5552,rigid,13825,18239,21695,4414,3456,7870,completed
5553,rigid,13825,18239,21695,4414,3456,7870,completed
5554,rigid,13825,18239,21695,4414,3456,7870,completed
5555,rigid,13825,18239,21695,4414,3456,7870,completed
5556,rigid,13825,18239,21695,4414,3456,7870,completed
5557,rigid,13825,18239,21695,4414,3456,7870,completed
5558,rigid,13825,18239,19352,4414,1113,5527,completed
5559,rigid,13825,18239,19261,4414,1022,5436,completed
5560,rigid,13825,18239,19630,4414,1391,5805,completed
5561,rigid,13825,18239,19656,4414,1417,5831,completed
5562,rigid,13825,18239,19218,4414,979,5393,completed
5563,rigid,13825,18239,21695,4414,3456,7870,completed
5564,rigid,13825,18239,21695,4414,3456,7870,completed
5565,rigid,13825,18239,21695,4414,3456,7870,completed
5566,rigid,13825,18239,21695,4414,3456,7870,completed
5567,rigid,13825,18239,21695,4414,3456,7870,completed
5568,rigid,13825,18239,21695,4414,3456,7870,completed
5569,rigid,13825,18239,21695,4414,3456,7870,completed
5570,rigid,13825,18239,21695,4414,3456,7870,completed
5571,rigid,13825,18239,21695,4414,3456,7870,completed
5572,rigid,13825,18239,21695,4414,3456,7870,completed
5573,rigid,13825,18239,21695,4414,3456,7870,completed
5574,rigid,13825,18239,21695,4414,3456,7870,completed
5575,rigid,13825,18239,21695,4414,3456,7870,completed
5576,rigid,13825,18239,21695,4414,3456,7870,completed
5577,rigid,13825,18239,21695,4414,3456,7870,completed
5578,rigid,13825,18239,21695,4414,3456,7870,completed
5579,rigid,13825,18239,21695,4414,3456,7870,completed
5580,rigid,13825,18239,21695,4414,3456,7870,completed
5581,rigid,13825,18239,21695,4414,3456,7870,completed
5582,rigid,13825,18239,21695,4414,3456,7870,completed
5583,rigid,13825,18239,21695,4414,3456,7870,completed
5584,rigid,13825,18239,21695,4414,3456,7870,completed
5585,rigid,13825,18239,21695,4414,3456,7870,completed
5586,rigid,13825,18239,21695,4414,3456,7870,completed
5587,rigid,13825,18239,21695,4414,3456,7870,completed
5588,rigid,13825,18239,21695,4414,3456,7870,completed
5589,rigid,13825,18239,21695,4414,3456,7870,completed
5590,rigid,13825,18239,21695,4414,3456,7870,completed
5591,rigid,13825,18239,21695,4414,3456,7870,completed
5592,rigid,13825,18239,21695,4414,3456,7870,completed
5593,rigid,13825,18239,21695,4414,3456,7870,completed
5594,rigid,13825,18239,21695,4414,3456,7870,completed
5595,rigid,13825,18239,21695,4414,3456,7870,completed
5596,rigid,13825,18239,21695,4414,3456,7870,completed
5597,rigid,13825,18239,21695,4414,3456,7870,completed
5598,rigid,13825,18239,21695,4414,3456,7870,completed
5599,rigid,13825,18239,21695,4414,3456,7870,completed
5600,rigid,13825,18239,21695,4414,3456,7870,completed
5601,rigid,13825,18239,21695,4414,3456,7870,completed
5602,rigid,13825,18239,21695,4414,3456,7870,completed
5603,rigid,13825,18239,21695,4414,3456,7870,completed
5604,rigid,13825,18239,21695,4414,3456,7870,completed
5605,rigid,13825,18239,21695,4414,3456,7870,completed
5606,rigid,13825,18239,21695,4414,3456,7870,completed
5607,rigid,13825,18239,21695,4414,3456,7870,completed
5608,rigid,13825,18239,21695,4414,3456,7870,completed
5609,rigid,13825,18239,21695,4414,3456,7870,completed
5610,rigid,13825,18239,21695,4414,3456,7870,completed
5611,rigid,13825,18239,21695,4414,3456,7870,completed
5612,rigid,13825,18239,21564,4414,3325,7739,completed
5613,rigid,13825,18239,21695,4414,3456,7870,completed
5614,rigid,13825,18239,21695,4414,3456,7870,completed
5615,rigid,13825,18239,21695,4414,3456,7870,completed
5616,rigid,13825,18239,21695,4414,3456,7870,completed
5617,rigid,13825,18239,21695,4414,3456,7870,completed
5618,rigid,13825,18239,21695,4414,3456,7870,completed
5619,rigid,13825,18239,21695,4414,3456,7870,completed
5620,rigid,13825,18239,21695,4414,3456,7870,completed
5621,rigid,13840,18242,18243,4402,1,4403,completed
5622,rigid,13842,18242,18243,4400,1,4401,completed
5623,rigid,13845,18242,18557,4397,315,4712,completed
5624,rigid,13845,18242,19106,4397,864,5261,completed
5625,rigid,13846,18242,21842,4396,3600,7996,completed
5626,rigid,13849,18242,21842,4393,3600,7993,completed
5627,rigid,13855,18243,18272,4388,29,4417,completed
5628,rigid,13857,18243,18244,4386,1,4387,completed
5629,rigid,13860,18244,19972,4384,1728,6112,completed
5630,rigid,13860,18244,18333,4384,89,4473,completed
5631,rigid,13860,18244,18427,4384,183,4567,completed
5632,rigid,13860,18244,19605,4384,1361,5745,completed
5633,rigid,13860,18244,19505,4384,1261,5645,completed
5634,rigid,13860,18244,19363,4384,1119,5503,completed
5635,rigid,13861,18245,18974,4384,729,5113,completed
5636,rigid,13861,18245,18776,4384,531,4915,completed
5637,rigid,13861,18245,18423,4384,178,4562,completed
5638,rigid,13861,18245,19148,4384,903,5287,completed
5639,rigid,13861,18245,19973,4384,1728,6112,completed
5640,rigid,13861,18245,19212,4384,967,5351,completed
5641,rigid,13865,18246,19658,4381,1412,5793,completed
5642,rigid,13865,18247,18966,4382,719,5101,completed
5643,rigid,13865,18247,19931,4382,1684,6066,completed
5644,rigid,13866,18247,18877,4381,630,5011,completed
5645,rigid,13866,18247,18876,4381,629,5010,completed
5646,rigid,13866,18247,18893,4381,646,5027,completed
5647,rigid,13866,18247,19975,4381,1728,6109,completed
5648,rigid,13866,18247,19426,4381,1179,5560,completed
5649,rigid,13866,18247,19042,4381,795,5176,completed
5650,rigid,13867,18247,19200,4380,953,5333,completed
5651,rigid,13867,18247,19452,4380,1205,5585,completed
5652,rigid,13867,18247,19401,4380,1154,5534,completed
5653,rigid,13867,18247,19480,4380,1233,5613,completed
5654,rigid,13867,18247,19560,4380,1313,5693,completed
5655,rigid,13867,18247,19776,4380,1529,5909,completed
5656,rigid,13867,18247,18836,4380,589,4969,completed
5657,rigid,13867,18247,19144,4380,897,5277,completed
5658,rigid,13867,18252,19980,4385,1728,6113,completed
5659,rigid,13868,18253,18265,4385,12,4397,completed
5660,rigid,13868,18255,18269,4387,14,4401,completed
5661,rigid,13868,18255,18279,4387,24,4411,completed
5662,rigid,13868,18255,18276,4387,21,4408,completed
5663,rigid,13868,18255,18287,4387,32,4419,completed
5664,rigid,13868,18255,18272,4387,17,4404,completed
5665,rigid,13868,18255,18268,4387,13,4400,completed
5666,rigid,13868,18259,18274,4391,15,4406,completed
5667,rigid,13868,18259,18276,4391,17,4408,completed
5668,rigid,13868,18259,18294,4391,35,4426,completed
5669,rigid,13868,18259,18282,4391,23,4414,completed
5670,rigid,13868,18259,18275,4391,16,4407,completed
5671,rigid,13868,18259,18308,4391,49,4440,completed
5672,rigid,13868,18259,18282,4391,23,4414,completed
5673,rigid,13868,18259,18288,4391,29,4420,completed
5674,rigid,13868,18259,18274,4391,15,4406,completed
5675,rigid,13868,18259,18291,4391,32,4423,completed
5676,rigid,13868,18259,18336,4391,77,4468,completed
5677,rigid,13868,18259,18272,4391,13,4404,completed
5678,rigid,13868,18260,18272,4392,12,4404,completed
5679,rigid,13868,18260,18267,4392,7,4399,completed
5680,rigid,13868,18260,18316,4392,56,4448,completed
5681,rigid,13868,18260,18284,4392,24,4416,completed
5682,rigid,13868,18260,18368,4392,108,4500,completed
5683,rigid,13868,18260,18321,4392,61,4453,completed
5684,rigid,13868,18265,18277,4397,12,4409,completed
5685,rigid,13868,18267,18286,4399,19,4418,completed
5686,rigid,13868,18267,18283,4399,16,4415,completed
5687,rigid,13868,18268,18281,4400,13,4413,completed
5688,rigid,13868,18269,18281,4401,12,4413,completed
5689,rigid,13868,18270,18288,4402,18,4420,completed
5690,rigid,13868,18270,18368,4402,98,4500,completed
5691,rigid,13868,18270,18287,4402,17,4419,completed
5692,rigid,13868,18270,18281,4402,11,4413,completed
5693,rigid,13868,18270,18289,4402,19,4421,completed
5694,rigid,13868,18270,18324,4402,54,4456,completed
5695,rigid,13868,18270,18286,4402,16,4418,completed
5696,rigid,13868,18270,18295,4402,25,4427,completed
5697,rigid,13868,18270,18283,4402,13,4415,completed
5698,rigid,13868,18270,18319,4402,49,4451,completed
5699,rigid,13868,18270,18280,4402,10,4412,completed
5700,rigid,13868,18272,18315,4404,43,4447,completed
5701,rigid,13868,18272,18324,4404,52,4456,completed
5702,rigid,13868,18272,18281,4404,9,4413,completed
5703,rigid,13868,18272,18310,4404,38,4442,completed
5704,rigid,13868,18274,18303,4406,29,4435,completed
5705,rigid,13868,18274,18284,4406,10,4416,completed
5706,rigid,13868,18274,18334,4406,60,4466,completed
5707,rigid,13868,18275,18396,4407,121,4528,completed
5708,rigid,13868,18276,18288,4408,12,4420,completed
5709,rigid,13868,18276,18300,4408,24,4432,completed
5710,rigid,13868,18277,18319,4409,42,4451,completed
5711,rigid,13868,18278,18312,4410,34,4444,completed
5712,rigid,13868,18279,18489,4411,210,4621,completed
5713,rigid,13868,18280,18325,4412,45,4457,completed
5714,rigid,13868,18281,18310,4413,29,4442,completed
5715,rigid,13868,18281,18380,4413,99,4512,completed
5716,rigid,13868,18281,18316,4413,35,4448,completed
5717,rigid,13868,18281,18327,4413,46,4459,completed
5718,rigid,13883,18281,18285,4398,4,4402,completed
5719,rigid,13883,18281,18288,4398,7,4405,completed
5720,rigid,13887,18281,18284,4394,3,4397,completed
5721,rigid,13887,18281,18284,4394,3,4397,completed
5722,rigid,13887,18281,18284,4394,3,4397,completed
5723,rigid,13887,18281,18284,4394,3,4397,completed
5724,rigid,13887,18281,18284,4394,3,4397,completed
5725,rigid,13887,18281,18284,4394,3,4397,completed
5726,rigid,13887,18281,18284,4394,3,4397,completed
5727,rigid,13887,18281,18284,4394,3,4397,completed
5728,rigid,13887,18281,18284,4394,3,4397,completed
5729,rigid,13887,18281,18284,4394,3,4397,completed
5730,rigid,13887,18281,18284,4394,3,4397,completed
5731,rigid,13887,18281,18284,4394,3,4397,completed
5732,rigid,13887,18281,18284,4394,3,4397,completed
5733,rigid,13887,18281,18284,4394,3,4397,completed
5734,rigid,13887,18281,18284,4394,3,4397,completed
5735,rigid,13887,18281,18284,4394,3,4397,completed
5736,rigid,13887,18281,18284,4394,3,4397,completed
5737,rigid,13887,18281,18284,4394,3,4397,completed
5738,rigid,13887,18281,18284,4394,3,4397,completed
5739,rigid,13887,18281,18284,4394,3,4397,completed
5740,rigid,13887,18281,18284,4394,3,4397,completed
5741,rigid,13887,18281,18284,4394,3,4397,completed
5742,rigid,13887,18281,18284,4394,3,4397,completed
5743,rigid,13887,18281,18284,4394,3,4397,completed
5744,rigid,13887,18281,18284,4394,3,4397,completed
5745,rigid,13887,18281,18284,4394,3,4397,completed
5746,rigid,13887,18281,18284,4394,3,4397,completed
5747,rigid,13887,18281,18284,4394,3,4397,completed
5748,rigid,13887,18281,18284,4394,3,4397,completed
5749,rigid,13887,18281,18284,4394,3,4397,completed
5750,rigid,13887,18281,18284,4394,3,4397,completed
5751,rigid,13887,18281,18284,4394,3,4397,completed
5752,rigid,13887,18281,18284,4394,3,4397,completed
5753,rigid,13887,18281,18284,4394,3,4397,completed
5754,rigid,13887,18281,18284,4394,3,4397,completed
5755,rigid,13889,18282,18286,4393,4,4397,completed
5756,rigid,13891,18282,18284,4391,2,4393,completed
5757,rigid,13891,18282,18284,4391,2,4393,completed
5758,rigid,13891,18282,18284,4391,2,4393,completed
5759,rigid,13891,18282,18284,4391,2,4393,completed
5760,rigid,13891,18282,18284,4391,2,4393,completed
5761,rigid,13891,18282,18284,4391,2,4393,completed
5762,rigid,13891,18282,18284,4391,2,4393,completed
5763,rigid,13891,18282,18284,4391,2,4393,completed
5764,rigid,13891,18282,18284,4391,2,4393,completed
5765,rigid,13891,18282,18284,4391,2,4393,completed
5766,rigid,13891,18282,18284,4391,2,4393,completed
5767,rigid,13891,18282,18284,4391,2,4393,completed
5768,rigid,13891,18282,18284,4391,2,4393,completed
5769,rigid,13891,18282,18284,4391,2,4393,completed
5770,rigid,13891,18282,18284,4391,2,4393,completed
5771,rigid,13891,18282,18284,4391,2,4393,completed
5772,rigid,13891,18282,18284,4391,2,4393,completed
5773,rigid,13891,18282,18284,4391,2,4393,completed
5774,rigid,13891,18282,18284,4391,2,4393,completed
5775,rigid,13891,18282,18284,4391,2,4393,completed
5776,rigid,13891,18282,18284,4391,2,4393,completed
5777,rigid,13891,18282,18284,4391,2,4393,completed
5778,rigid,13891,18282,18283,4391,1,4392,completed
5779,rigid,13891,18282,18284,4391,2,4393,completed
5780,rigid,13891,18282,18284,4391,2,4393,completed
5781,rigid,13891,18282,18284,4391,2,4393,completed
5782,rigid,13891,18282,18284,4391,2,4393,completed
5783,rigid,13891,18282,18284,4391,2,4393,completed
5784,rigid,13891,18282,18284,4391,2,4393,completed
5785,rigid,13891,18282,18284,4391,2,4393,completed
5786,rigid,13891,18282,18284,4391,2,4393,completed
5787,rigid,13891,18282,18284,4391,2,4393,completed
5788,rigid,13891,18282,18284,4391,2,4393,completed
5789,rigid,13891,18282,18284,4391,2,4393,completed
5790,rigid,13891,18282,18284,4391,2,4393,completed
5791,rigid,13891,18282,18284,4391,2,4393,completed
5792,rigid,13891,18282,18284,4391,2,4393,completed
5793,rigid,13891,18282,18283,4391,1,4392,completed
5794,rigid,13891,18282,18284,4391,2,4393,completed
5795,rigid,13891,18282,18284,4391,2,4393,completed
5796,rigid,13891,18282,18284,4391,2,4393,completed
5797,rigid,13891,18282,18284,4391,2,4393,completed
5798,rigid,13891,18282,18284,4391,2,4393,completed
5799,rigid,13891,18282,18284,4391,2,4393,completed
5800,rigid,13891,18282,18283,4391,1,4392,completed
5801,rigid,13891,18282,18283,4391,1,4392,completed
5802,rigid,13891,18282,18284,4391,2,4393,completed
5803,rigid,13891,18282,18284,4391,2,4393,completed
5804,rigid,13891,18282,18284,4391,2,4393,completed
5805,rigid,13891,18282,18284,4391,2,4393,completed
5806,rigid,13891,18282,18284,4391,2,4393,completed
5807,rigid,13891,18282,18284,4391,2,4393,completed
5808,rigid,13891,18282,18284,4391,2,4393,completed
5809,rigid,13891,18282,18284,4391,2,4393,completed
5810,rigid,13891,18282,18284,4391,2,4393,completed
5811,rigid,13891,18282,18284,4391,2,4393,completed
5812,rigid,13891,18282,18284,4391,2,4393,completed
5813,rigid,13891,18282,18284,4391,2,4393,completed
5814,rigid,13891,18282,18284,4391,2,4393,completed
5815,rigid,13891,18283,18285,4392,2,4394,completed
5816,rigid,13891,18283,18284,4392,1,4393,completed
5817,rigid,13891,18283,18285,4392,2,4394,completed
5818,rigid,13891,18283,18285,4392,2,4394,completed
5819,rigid,13891,18283,18285,4392,2,4394,completed
5820,rigid,13891,18283,18285,4392,2,4394,completed
5821,rigid,13891,18283,18285,4392,2,4394,completed
5822,rigid,13891,18283,18285,4392,2,4394,completed
5823,rigid,13891,18283,18285,4392,2,4394,completed
5824,rigid,13891,18283,18285,4392,2,4394,completed
5825,rigid,13891,18283,18285,4392,2,4394,completed
5826,rigid,13891,18283,18285,4392,2,4394,completed
5827,rigid,13891,18283,18285,4392,2,4394,completed
5828,rigid,13894,18283,18294,4389,11,4400,completed
5829,rigid,13894,18284,18309,4390,25,4415,completed
5830,rigid,13895,18284,18304,4389,20,4409,completed
5831,rigid,13898,18284,18301,4386,17,4403,completed
5832,rigid,13900,18286,18367,4386,81,4467,completed
5833,rigid,13901,18286,18294,4385,8,4393,completed
5834,rigid,13902,18287,18290,4385,3,4388,completed
5835,rigid,13909,18288,18292,4379,4,4383,completed
5836,rigid,13910,18290,18311,4380,21,4401,completed
5837,rigid,13910,18292,18313,4382,21,4403,completed
5838,rigid,13910,18293,18314,4383,21,4404,completed
5839,rigid,13910,18294,18315,4384,21,4405,completed
5840,rigid,13910,18298,18319,4388,21,4409,completed
5841,rigid,13910,18298,18319,4388,21,4409,completed
5842,rigid,13910,18298,18319,4388,21,4409,completed
5843,rigid,13910,18301,18322,4391,21,4412,completed
5844,rigid,13910,18305,18326,4395,21,4416,completed
5845,rigid,13910,18305,18326,4395,21,4416,completed
5846,rigid,13910,18310,18331,4400,21,4421,completed
5847,rigid,13910,18311,18332,4401,21,4422,completed
5848,rigid,13910,18313,18334,4403,21,4424,completed
5849,rigid,13910,18314,18335,4404,21,4425,completed
5850,rigid,13910,18315,18336,4405,21,4426,completed
5851,rigid,13910,18316,18337,4406,21,4427,completed
5852,rigid,13915,18319,18328,4404,9,4413,completed
5853,rigid,13923,18319,19125,4396,806,5202,completed
5854,rigid,13926,18319,19131,4393,812,5205,completed
5855,rigid,13932,18326,19818,4394,1492,5886,completed
5856,rigid,13948,18326,18330,4378,4,4382,completed
5857,rigid,13956,18328,18329,4372,1,4373,completed
5858,rigid,13956,18329,18330,4373,1,4374,completed
5859,rigid,13956,18330,18331,4374,1,4375,completed
5860,rigid,13956,18331,18332,4375,1,4376,completed
5861,rigid,13956,18331,18332,4375,1,4376,completed
5862,rigid,13958,18332,18909,4374,577,4951,completed
5863,rigid,13958,18332,18873,4374,541,4915,completed
5864,rigid,13958,18332,18942,4374,610,4984,completed
5865,rigid,13958,18334,18860,4376,526,4902,completed
5866,rigid,13958,18334,18869,4376,535,4911,completed
5867,rigid,13961,18335,19161,4374,826,5200,completed
5868,rigid,13973,18335,19281,4362,946,5308,completed
5869,rigid,13974,18336,19150,4362,814,5176,completed
5870,rigid,13975,18337,19150,4362,813,5175,completed
5871,rigid,13975,18337,19250,4362,913,5275,completed
5872,rigid,13991,18337,18343,4346,6,4352,completed
5873,rigid,13991,18338,18344,4347,6,4353,completed
5874,rigid,13991,18343,18349,4352,6,4358,completed
5875,rigid,13991,18344,18350,4353,6,4359,completed
5876,rigid,13991,18349,18355,4358,6,4364,completed
5877,rigid,13991,18350,18356,4359,6,4365,completed
5878,rigid,13991,18355,18361,4364,6,4370,completed
5879,rigid,13991,18356,18362,4365,6,4371,completed
5880,rigid,13991,18356,18362,4365,6,4371,completed
5881,rigid,13991,18356,18362,4365,6,4371,completed
5882,rigid,13991,18356,18362,4365,6,4371,completed
5883,rigid,13991,18356,18362,4365,6,4371,completed
5884,rigid,13991,18361,18367,4370,6,4376,completed
5885,rigid,13991,18362,18368,4371,6,4377,completed
5886,rigid,13991,18362,18368,4371,6,4377,completed
5887,rigid,13991,18362,18368,4371,6,4377,completed
5888,rigid,14009,18362,18393,4353,31,4384,completed
5889,rigid,14072,18368,18372,4296,4,4300,completed
5890,rigid,14104,18372,18373,4268,1,4269,completed
5891,rigid,14140,18372,18400,4232,28,4260,completed
5892,rigid,14140,18372,18400,4232,28,4260,completed
5893,rigid,14170,18372,18376,4202,4,4206,completed
5894,rigid,14170,18372,18376,4202,4,4206,completed
5895,rigid,14170,18372,18393,4202,21,4223,completed
5896,rigid,14170,18372,18376,4202,4,4206,completed
5897,rigid,14170,18372,18375,4202,3,4205,completed
5898,rigid,14170,18372,18375,4202,3,4205,completed
5899,rigid,14170,18372,18381,4202,9,4211,completed
5900,rigid,14170,18372,18391,4202,19,4221,completed
5901,rigid,14170,18372,18396,4202,24,4226,completed
5902,rigid,14170,18372,18381,4202,9,4211,completed
5903,rigid,14170,18372,18394,4202,22,4224,completed
5904,rigid,14170,18372,18376,4202,4,4206,completed
5905,rigid,14170,18372,18393,4202,21,4223,completed
5906,rigid,14170,18372,18385,4202,13,4215,completed
5907,rigid,14170,18372,18385,4202,13,4215,completed
5908,rigid,14170,18372,18394,4202,22,4224,completed
5909,rigid,14170,18372,18379,4202,7,4209,completed
5910,rigid,14170,18372,18380,4202,8,4210,completed
5911,rigid,14170,18372,18386,4202,14,4216,completed
5912,rigid,14170,18372,18386,4202,14,4216,completed
5913,rigid,14170,18372,18392,4202,20,4222,completed
5914,rigid,14170,18372,18393,4202,21,4223,completed
5915,rigid,14170,18372,18385,4202,13,4215,completed
5916,rigid,14170,18372,18381,4202,9,4211,completed
5917,rigid,14170,18372,18376,4202,4,4206,completed
5918,rigid,14170,18372,18376,4202,4,4206,completed
5919,rigid,14170,18372,18396,4202,24,4226,completed
5920,rigid,14170,18372,18397,4202,25,4227,completed
5921,rigid,14170,18372,18385,4202,13,4215,completed
5922,rigid,14170,18372,18385,4202,13,4215,completed
5923,rigid,14170,18372,18379,4202,7,4209,completed
5924,rigid,14170,18372,18380,4202,8,4210,completed
5925,rigid,14170,18372,18381,4202,9,4211,completed
5926,rigid,14170,18372,18382,4202,10,4212,completed
5927,rigid,14170,18372,18382,4202,10,4212,completed
5928,rigid,14170,18372,18376,4202,4,4206,completed
5929,rigid,14170,18372,18385,4202,13,4215,completed
5930,rigid,14170,18372,18382,4202,10,4212,completed
5931,rigid,14170,18372,18376,4202,4,4206,completed
5932,rigid,14170,18372,18385,4202,13,4215,completed
5933,rigid,14170,18372,18376,4202,4,4206,completed
5934,rigid,14170,18372,18382,4202,10,4212,completed
5935,rigid,14170,18372,18385,4202,13,4215,completed
5936,rigid,14170,18372,18375,4202,3,4205,completed
5937,rigid,14170,18372,18375,4202,3,4205,completed
5938,rigid,14170,18372,18381,4202,9,4211,completed
5939,rigid,14170,18372,18381,4202,9,4211,completed
5940,rigid,14170,18372,18385,4202,13,4215,completed
5941,rigid,14170,18372,18388,4202,16,4218,completed
5942,rigid,14170,18372,18373,4202,1,4203,completed
5943,rigid,14170,18372,18373,4202,1,4203,completed
5944,rigid,14170,18372,18375,4202,3,4205,completed
5945,rigid,14170,18372,18388,4202,16,4218,completed
5946,rigid,14170,18372,18385,4202,13,4215,completed
5947,rigid,14170,18372,18384,4202,12,4214,completed
5948,rigid,14170,18372,18384,4202,12,4214,completed
5949,rigid,14177,18373,19171,4196,798,4994,completed
5950,rigid,14196,18373,18392,4177,19,4196,completed
5951,rigid,14196,18373,18393,4177,20,4197,completed
5952,rigid,14196,18373,18393,4177,20,4197,completed
5953,rigid,14196,18373,18392,4177,19,4196,completed
5954,rigid,14224,18373,18374,4149,1,4150,completed
5955,rigid,14228,18373,18374,4145,1,4146,completed
5956,rigid,14230,18373,18409,4143,36,4179,completed
5957,rigid,14260,18373,25591,4113,7218,11331,completed
5958,rigid,14369,18376,18457,4007,81,4088,completed
5959,rigid,14485,18387,18914,3902,527,4429,completed
5960,rigid,14491,18393,18429,3902,36,3938,completed
5961,rigid,14491,18423,18460,3932,37,3969,completed
5962,rigid,14491,18429,18466,3938,37,3975,completed
5963,rigid,14491,18456,18493,3965,37,4002,completed
5964,rigid,14491,18457,18494,3966,37,4003,completed
5965,rigid,14491,18460,18497,3969,37,4006,completed
5966,rigid,14491,18466,18503,3975,37,4012,completed
5967,rigid,14491,18493,18530,4002,37,4039,completed
5968,rigid,14491,18494,18531,4003,37,4040,completed
5969,rigid,14491,18497,18534,4006,37,4043,completed
5970,rigid,14491,18503,18539,4012,36,4048,completed
5971,rigid,14491,18523,18559,4032,36,4068,completed
5972,rigid,14491,18526,18562,4035,36,4071,completed
5973,rigid,14491,18528,18564,4037,36,4073,completed
5974,rigid,14491,18530,18567,4039,37,4076,completed
5975,rigid,14491,18531,18568,4040,37,4077,completed
5976,rigid,14493,18534,19085,4041,551,4592,completed
5977,rigid,14500,18534,19076,4034,542,4576,completed
5978,rigid,14518,18550,18562,4032,12,4044,completed
5979,rigid,14520,18550,18586,4030,36,4066,completed
5980,rigid,14535,18552,19121,4017,569,4586,completed
5981,rigid,14564,18552,18562,3988,10,3998,completed
5982,rigid,14568,18555,19166,3987,611,4598,completed
5983,rigid,14578,18555,18971,3977,416,4393,completed
5984,rigid,14580,18555,18597,3975,42,4017,completed
5985,rigid,14580,18555,18731,3975,176,4151,completed
5986,rigid,14580,18555,18733,3975,178,4153,completed
5987,rigid,14584,18556,18773,3972,217,4189,completed
5988,rigid,14612,18556,18570,3944,14,3958,completed
5989,rigid,14612,18556,18570,3944,14,3958,completed
5990,rigid,14612,18556,18570,3944,14,3958,completed
5991,rigid,14612,18556,18570,3944,14,3958,completed
5992,rigid,14612,18556,18570,3944,14,3958,completed
5993,rigid,14612,18557,18571,3945,14,3959,completed
5994,rigid,14612,18557,18571,3945,14,3959,completed
5995,rigid,14612,18557,18571,3945,14,3959,completed
5996,rigid,14612,18557,18571,3945,14,3959,completed
5997,rigid,14612,18557,18571,3945,14,3959,completed
5998,rigid,14612,18557,18571,3945,14,3959,completed
5999,rigid,14612,18557,18571,3945,14,3959,completed
6000,rigid,14612,18557,18571,3945,14,3959,completed
6001,rigid,14612,18557,18571,3945,14,3959,completed
6002,rigid,14612,18557,18571,3945,14,3959,completed
6003,rigid,14612,18557,18571,3945,14,3959,completed
6004,rigid,14633,18557,18568,3924,11,3935,completed
6005,rigid,14633,18557,18584,3924,27,3951,completed
6006,rigid,14704,18559,23956,3855,5397,9252,completed
6007,rigid,14740,18560,19695,3820,1135,4955,completed
6008,rigid,14746,18560,19690,3814,1130,4944,completed
6009,rigid,14749,18560,18564,3811,4,3815,completed
6010,rigid,14754,18560,20058,3806,1498,5304,completed
6011,rigid,14756,18560,20057,3804,1497,5301,completed
6012,rigid,14771,18560,20044,3789,1484,5273,completed
6013,rigid,14773,18560,20044,3787,1484,5271,completed
6014,rigid,14785,18561,19653,3776,1092,4868,completed
6015,rigid,14836,18561,18569,3725,8,3733,completed
6016,rigid,14850,18561,18568,3711,7,3718,completed
6017,rigid,14863,18562,18565,3699,3,3702,completed
6018,rigid,14866,18562,18570,3696,8,3704,completed
6019,rigid,14896,18562,18568,3666,6,3672,completed
6020,rigid,14902,18562,18567,3660,5,3665,completed
6021,rigid,14908,18562,18598,3654,36,3690,completed
6022,rigid,14977,18562,19841,3585,1279,4864,completed
6023,rigid,14979,18567,20046,3588,1479,5067,completed
6024,rigid,14979,18570,20007,3591,1437,5028,completed
6025,rigid,15012,18571,19102,3559,531,4090,completed
6026,rigid,15016,18571,18573,3555,2,3557,completed
6027,rigid,15016,18571,18573,3555,2,3557,completed
6028,rigid,15016,18573,18576,3557,3,3560,completed
6029,rigid,15016,18573,18576,3557,3,3560,completed
6030,rigid,15040,18573,18577,3533,4,3537,completed
6031,rigid,15042,18576,19118,3534,542,4076,completed
6032,rigid,15045,18576,19138,3531,562,4093,completed
6033,rigid,15052,18576,18577,3524,1,3525,completed
6034,rigid,15105,18576,19150,3471,574,4045,completed
6035,rigid,15180,18587,19204,3407,617,4024,completed
6036,rigid,15347,18587,18802,3240,215,3455,completed
6037,rigid,15371,18587,18965,3216,378,3594,completed
6038,rigid,15372,18620,19121,3248,501,3749,completed
6039,rigid,15383,18622,18673,3239,51,3290,completed
6040,rigid,15385,18623,19306,3238,683,3921,completed
6041,rigid,15402,18628,18660,3226,32,3258,completed
6042,rigid,15417,18630,19383,3213,753,3966,completed
6043,rigid,15430,18641,18655,3211,14,3225,completed
6044,rigid,15431,18655,18668,3224,13,3237,completed
6045,rigid,15432,18660,18673,3228,13,3241,completed
6046,rigid,15434,18668,18677,3234,9,3243,completed
6047,rigid,15434,18673,18683,3239,10,3249,completed
6048,rigid,15435,18673,18753,3238,80,3318,completed
6049,rigid,15436,18673,19046,3237,373,3610,completed
6050,rigid,15440,18677,20402,3237,1725,4962,completed
6051,rigid,15441,18683,19505,3242,822,4064,completed
6052,rigid,15442,18687,20414,3245,1727,4972,completed
6053,rigid,15443,18702,20430,3259,1728,4987,completed
6054,rigid,15444,18702,18732,3258,30,3288,completed
6055,rigid,15445,18830,20326,3385,1496,4881,completed
6056,rigid,15445,18836,18864,3391,28,3419,completed
6057,rigid,15474,18860,18883,3386,23,3409,completed
6058,rigid,15487,18860,18891,3373,31,3404,completed
6059,rigid,15489,18868,19047,3379,179,3558,completed
6060,rigid,15489,18869,18973,3380,104,3484,completed
6061,rigid,15489,18873,18874,3384,1,3385,completed
6062,rigid,15489,18874,18879,3385,5,3390,completed
6063,rigid,15489,18879,18975,3390,96,3486,completed
6064,rigid,15489,18883,18988,3394,105,3499,completed
6065,rigid,15489,18891,18996,3402,105,3507,completed
6066,rigid,15489,18909,18911,3420,2,3422,completed
6067,rigid,15489,18911,18914,3422,3,3425,completed
6068,rigid,15489,18914,18917,3425,3,3428,completed
6069,rigid,15489,18914,18915,3425,1,3426,completed
6070,rigid,15489,18915,18919,3426,4,3430,completed
6071,rigid,15489,18917,18919,3428,2,3430,completed
6072,rigid,15489,18919,18921,3430,2,3432,completed
6073,rigid,15489,18919,18922,3430,3,3433,completed
6074,rigid,15489,18921,18924,3432,3,3435,completed
6075,rigid,15489,18922,18928,3433,6,3439,completed
6076,rigid,15489,18924,18927,3435,3,3438,completed
6077,rigid,15489,18927,18928,3438,1,3439,completed
6078,rigid,15489,18928,18931,3439,3,3442,completed
6079,rigid,15489,18928,18935,3439,7,3446,completed
6080,rigid,15489,18928,18929,3439,1,3440,completed
6081,rigid,15489,18929,18934,3440,5,3445,completed
6082,rigid,15489,18931,18936,3442,5,3447,completed
6083,rigid,15489,18934,18938,3445,4,3449,completed
6084,rigid,15489,18935,18936,3446,1,3447,completed
6085,rigid,15489,18936,18946,3447,10,3457,completed
6086,rigid,15489,18936,19036,3447,100,3547,completed
6087,rigid,15498,18938,18955,3440,17,3457,completed
6088,rigid,15509,18942,21174,3433,2232,5665,completed
6089,rigid,15516,18942,19100,3426,158,3584,completed
6090,rigid,15520,18942,18967,3422,25,3447,completed
6091,rigid,15524,18946,18975,3422,29,3451,completed
6092,rigid,15535,18946,18978,3411,32,3443,completed
6093,rigid,15543,18965,19498,3422,533,3955,completed
6094,rigid,15546,18965,19067,3419,102,3521,completed
6095,rigid,15547,18965,18995,3418,30,3448,completed
6096,rigid,15553,18973,19117,3420,144,3564,completed
6097,rigid,15561,18974,19008,3413,34,3447,completed
6098,rigid,15566,18975,18976,3409,1,3410,completed
6099,rigid,15568,18975,18978,3407,3,3410,completed
6100,rigid,15571,18975,18985,3404,10,3414,completed
6101,rigid,15582,18976,19009,3394,33,3427,completed
6102,rigid,15582,18978,19044,3396,66,3462,completed
6103,rigid,15582,18978,19054,3396,76,3472,completed
6104,rigid,15583,18980,19065,3397,85,3482,completed
6105,rigid,15583,18985,19080,3402,95,3497,completed
6106,rigid,15585,18988,19531,3403,543,3946,completed
6107,rigid,15587,18988,19852,3401,864,4265,completed
6108,rigid,15595,18988,18989,3393,1,3394,completed
6109,rigid,15600,18995,19024,3395,29,3424,completed
6110,rigid,15608,18996,19558,3388,562,3950,completed
6111,rigid,15654,19009,19804,3355,795,4150,completed
6112,rigid,15680,19024,19573,3344,549,3893,completed
6113,rigid,15735,19085,19087,3350,2,3352,completed
6114,rigid,15738,19087,19089,3349,2,3351,completed
6115,rigid,15762,19089,19090,3327,1,3328,completed
6116,rigid,15766,19089,19092,3323,3,3326,completed
6117,rigid,15780,19089,19097,3309,8,3317,completed
6118,rigid,15796,19089,21252,3293,2163,5456,completed
6119,rigid,15797,19089,19520,3292,431,3723,completed
6120,rigid,15799,19089,19090,3290,1,3291,completed
6121,rigid,15809,19089,19109,3280,20,3300,completed
6122,rigid,15810,19089,19102,3279,13,3292,completed
6123,rigid,15810,19089,19109,3279,20,3299,completed
6124,rigid,15821,19089,19099,3268,10,3278,completed
6125,rigid,15822,19089,22306,3267,3217,6484,completed
6126,rigid,15822,19089,19098,3267,9,3276,completed
6127,rigid,15823,19089,19098,3266,9,3275,completed
6128,rigid,15824,19089,19097,3265,8,3273,completed
6129,rigid,15825,19090,19099,3265,9,3274,completed
6130,rigid,15830,19090,20045,3260,955,4215,completed
6131,rigid,15830,19090,19094,3260,4,3264,completed
6132,rigid,15831,19090,19339,3259,249,3508,completed
6133,rigid,15832,19090,19204,3258,114,3372,completed
6134,rigid,15833,19092,22298,3259,3206,6465,completed
6135,rigid,15837,19092,19260,3255,168,3423,completed
6136,rigid,15839,19092,19436,3253,344,3597,completed
6137,rigid,15840,19092,19856,3252,764,4016,completed
6138,rigid,15842,19094,22290,3252,3196,6448,completed
6139,rigid,15875,19097,19469,3222,372,3594,completed
6140,rigid,15876,19099,19472,3223,373,3596,completed
6141,rigid,15877,19100,19473,3223,373,3596,completed
6142,rigid,16154,19102,19834,2948,732,3680,completed
6143,rigid,16171,19109,19724,2938,615,3553,completed
6144,rigid,16176,19117,19948,2941,831,3772,completed
6145,rigid,16178,19117,19869,2939,752,3691,completed
6146,rigid,16188,19118,19889,2930,771,3701,completed
6147,rigid,16188,19118,19494,2930,376,3306,completed
6148,rigid,16188,19118,19612,2930,494,3424,completed
6149,rigid,16188,19118,19968,2930,850,3780,completed
6150,rigid,16188,19121,20222,2933,1101,4034,completed
6151,rigid,16188,19121,19615,2933,494,3427,completed
6152,rigid,16190,19121,20126,2931,1005,3936,completed
6153,rigid,16190,19121,19255,2931,134,3065,completed
6154,rigid,16190,19121,19395,2931,274,3205,completed
6155,rigid,16190,19121,20109,2931,988,3919,completed
6156,rigid,16190,19121,20281,2931,1160,4091,completed
6157,rigid,16190,19121,19717,2931,596,3527,completed
6158,rigid,16191,19124,20146,2933,1022,3955,completed
6159,rigid,16191,19125,20236,2934,1111,4045,completed
6160,rigid,16191,19125,20047,2934,922,3856,completed
6161,rigid,16192,19125,19441,2933,316,3249,completed
6162,rigid,16192,19131,19735,2939,604,3543,completed
6163,rigid,16192,19138,20157,2946,1019,3965,completed
6164,rigid,16192,19138,20029,2946,891,3837,completed
6165,rigid,16192,19138,20299,2946,1161,4107,completed
6166,rigid,16192,19138,20028,2946,890,3836,completed
6167,rigid,16192,19144,20481,2952,1337,4289,completed
6168,rigid,16192,19148,19890,2956,742,3698,completed
6169,rigid,16192,19150,20562,2958,1412,4370,completed
6170,rigid,16193,19150,20199,2957,1049,4006,completed
6171,rigid,16193,19150,19904,2957,754,3711,completed
6172,rigid,16193,19150,19848,2957,698,3655,completed
6173,rigid,16193,19150,20329,2957,1179,4136,completed
6174,rigid,16193,19150,20243,2957,1093,4050,completed
6175,rigid,16193,19150,20062,2957,912,3869,completed
6176,rigid,16193,19150,20183,2957,1033,3990,completed
6177,rigid,16193,19150,20290,2957,1140,4097,completed
6178,rigid,16193,19150,19830,2957,680,3637,completed
6179,rigid,16196,19150,19184,2954,34,2988,completed
6180,rigid,16201,19150,20878,2949,1728,4677,completed
6181,rigid,16201,19161,20889,2960,1728,4688,completed
6182,rigid,16201,19161,20889,2960,1728,4688,completed
6183,rigid,16202,19161,20889,2959,1728,4687,completed
6184,rigid,16202,19166,20894,2964,1728,4692,completed
6185,rigid,16202,19166,20894,2964,1728,4692,completed
6186,rigid,16202,19166,19598,2964,432,3396,completed
6187,rigid,16202,19166,19598,2964,432,3396,completed
6188,rigid,16203,19171,20035,2968,864,3832,completed
6189,rigid,16203,19180,20044,2977,864,3841,completed
6190,rigid,16204,19180,20110,2976,930,3906,completed
6191,rigid,16206,19180,20908,2974,1728,4702,completed
6192,rigid,16206,19184,20912,2978,1728,4706,completed
6193,rigid,16206,19200,20928,2994,1728,4722,completed
6194,rigid,16206,19204,20932,2998,1728,4726,completed
6195,rigid,16206,19204,20932,2998,1728,4726,completed
6196,rigid,16206,19204,20932,2998,1728,4726,completed
6197,rigid,16207,19204,20932,2997,1728,4725,completed
6198,rigid,16207,19204,20932,2997,1728,4725,completed
6199,rigid,16207,19212,20940,3005,1728,4733,completed
6200,rigid,16208,19224,19656,3016,432,3448,completed
6201,rigid,16209,19224,20952,3015,1728,4743,completed
6202,rigid,16209,19224,20952,3015,1728,4743,completed
6203,rigid,16209,19224,20952,3015,1728,4743,completed
6204,rigid,16209,19243,20971,3034,1728,4762,completed
6205,rigid,16209,19243,20971,3034,1728,4762,completed
6206,rigid,16209,19243,20971,3034,1728,4762,completed
6207,rigid,16210,19250,19270,3040,20,3060,completed
6208,rigid,16224,19250,19254,3026,4,3030,completed
6209,rigid,16231,19255,19906,3024,651,3675,completed
6210,rigid,16237,19270,19274,3033,4,3037,completed
6211,rigid,16240,19274,19276,3034,2,3036,completed
6212,rigid,16244,19274,20643,3030,1369,4399,completed
6213,rigid,16244,19276,21868,3032,2592,5624,completed
6214,rigid,16244,19281,19717,3037,436,3473,completed
6215,rigid,16244,19281,21873,3037,2592,5629,completed
6216,rigid,16244,19306,19917,3062,611,3673,completed
6217,rigid,16244,19306,21898,3062,2592,5654,completed
6218,rigid,16244,19306,20555,3062,1249,4311,completed
6219,rigid,16244,19306,21424,3062,2118,5180,completed
6220,rigid,16244,19339,20156,3095,817,3912,completed
6221,rigid,16244,19359,21951,3115,2592,5707,completed
6222,rigid,16244,19359,21049,3115,1690,4805,completed
6223,rigid,16244,19359,19821,3115,462,3577,completed
6224,rigid,16244,19359,21951,3115,2592,5707,completed
6225,rigid,16244,19359,19628,3115,269,3384,completed
6226,rigid,16244,19359,20269,3115,910,4025,completed
6227,rigid,16244,19363,21955,3119,2592,5711,completed
6228,rigid,16244,19383,19805,3139,422,3561,completed
6229,rigid,16244,19383,20512,3139,1129,4268,completed
6230,rigid,16244,19383,21975,3139,2592,5731,completed
6231,rigid,16244,19383,20265,3139,882,4021,completed
6232,rigid,16244,19395,21987,3151,2592,5743,completed
6233,rigid,16244,19401,20340,3157,939,4096,completed
6234,rigid,16244,19414,20134,3170,720,3890,completed
6235,rigid,16244,19414,21887,3170,2473,5643,completed
6236,rigid,16244,19414,19503,3170,89,3259,completed
6237,rigid,16244,19414,19538,3170,124,3294,completed
6238,rigid,16244,19414,19727,3170,313,3483,completed
6239,rigid,16244,19414,21520,3170,2106,5276,completed
6240,rigid,16244,19420,22012,3176,2592,5768,completed
6241,rigid,16244,19426,19530,3182,104,3286,completed
6242,rigid,16244,19436,19987,3192,551,3743,completed
6243,rigid,16244,19441,22033,3197,2592,5789,completed
6244,rigid,16244,19452,22044,3208,2592,5800,completed
6245,rigid,16244,19469,21109,3225,1640,4865,completed
6246,rigid,16244,19469,19959,3225,490,3715,completed
6247,rigid,16244,19469,21094,3225,1625,4850,completed
6248,rigid,16244,19472,22064,3228,2592,5820,completed
6249,rigid,16244,19472,19696,3228,224,3452,completed
6250,rigid,16244,19472,19845,3228,373,3601,completed
6251,rigid,16244,19473,22065,3229,2592,5821,completed
6252,rigid,16244,19473,19744,3229,271,3500,completed
6253,rigid,16244,19473,20048,3229,575,3804,completed
6254,rigid,16244,19480,20083,3236,603,3839,completed
6255,rigid,16244,19494,20031,3250,537,3787,completed
6256,rigid,16244,19498,20806,3254,1308,4562,completed
6257,rigid,16244,19498,22090,3254,2592,5846,completed
6258,rigid,16244,19498,20099,3254,601,3855,completed
6259,rigid,16244,19498,22090,3254,2592,5846,completed
6260,rigid,16244,19503,20109,3259,606,3865,completed
6261,rigid,16244,19505,20064,3261,559,3820,completed
6262,rigid,16244,19505,20792,3261,1287,4548,completed
6263,rigid,16244,19505,22097,3261,2592,5853,completed
6264,rigid,16244,19505,22097,3261,2592,5853,completed
6265,rigid,16244,19520,22112,3276,2592,5868,completed
6266,rigid,16244,19520,19681,3276,161,3437,completed
6267,rigid,16244,19520,20546,3276,1026,4302,completed
6268,rigid,16244,19520,22112,3276,2592,5868,completed
6269,rigid,16244,19522,19678,3278,156,3434,completed
6270,rigid,16244,19530,22122,3286,2592,5878,completed
6271,rigid,16244,19531,19627,3287,96,3383,completed
6272,rigid,16244,19531,22123,3287,2592,5879,completed
6273,rigid,16244,19531,20413,3287,882,4169,completed
6274,rigid,16244,19531,19585,3287,54,3341,completed
6275,rigid,16244,19538,22130,3294,2592,5886,completed
6276,rigid,16244,19542,22134,3298,2592,5890,completed
6277,rigid,16244,19558,22150,3314,2592,5906,completed
6278,rigid,16244,19558,19765,3314,207,3521,completed
6279,rigid,16244,19558,22150,3314,2592,5906,completed
6280,rigid,16244,19558,22150,3314,2592,5906,completed
6281,rigid,16244,19560,20847,3316,1287,4603,completed
6282,rigid,16244,19573,20781,3329,1208,4537,completed
6283,rigid,16244,19573,22165,3329,2592,5921,completed
6284,rigid,16244,19573,22165,3329,2592,5921,completed
6285,rigid,16244,19573,22165,3329,2592,5921,completed
6286,rigid,16244,19585,19872,3341,287,3628,completed
6287,rigid,16244,19598,20275,3354,677,4031,completed
6288,rigid,16244,19598,22178,3354,2580,5934,completed
6289,rigid,16244,19605,21346,3361,1741,5102,completed
6290,rigid,16244,19612,21069,3368,1457,4825,completed
6291,rigid,16244,19615,20200,3371,585,3956,completed
6292,rigid,16244,19627,20341,3383,714,4097,completed
6293,rigid,16244,19628,22146,3384,2518,5902,completed
6294,rigid,16244,19653,21625,3409,1972,5381,completed
6295,rigid,16244,19653,20012,3409,359,3768,completed
6296,rigid,16244,19653,21271,3409,1618,5027,completed
6297,rigid,16244,19656,21230,3412,1574,4986,completed
6298,rigid,16244,19658,22250,3414,2592,6006,completed
6299,rigid,16244,19678,21108,3434,1430,4864,completed
6300,rigid,16244,19681,21403,3437,1722,5159,completed
6301,rigid,16244,19690,22282,3446,2592,6038,completed
6302,rigid,16244,19695,22287,3451,2592,6043,completed
6303,rigid,16244,19695,22287,3451,2592,6043,completed
6304,rigid,16244,19717,22309,3473,2592,6065,completed
6305,rigid,16244,19724,20789,3480,1065,4545,completed
6306,rigid,16244,19724,22316,3480,2592,6072,completed
6307,rigid,16244,19727,20520,3483,793,4276,completed
6308,rigid,16244,19744,20648,3500,904,4404,completed
6309,rigid,16244,19776,20601,3532,825,4357,completed
6310,rigid,16244,19782,21883,3538,2101,5639,completed
6311,rigid,16244,19782,20506,3538,724,4262,completed
6312,rigid,16244,19789,20593,3545,804,4349,completed
6313,rigid,16244,19804,20942,3560,1138,4698,completed
6314,rigid,16244,19804,21425,3560,1621,5181,completed
6315,rigid,16244,19805,20912,3561,1107,4668,completed
6316,rigid,16244,19811,20311,3567,500,4067,completed
6317,rigid,16244,19818,20337,3574,519,4093,completed
6318,rigid,16244,19818,22410,3574,2592,6166,completed
6319,rigid,16244,19818,20182,3574,364,3938,completed
6320,rigid,16244,19818,22410,3574,2592,6166,completed
6321,rigid,16244,19818,22410,3574,2592,6166,completed
6322,rigid,16244,19818,22410,3574,2592,6166,completed
6323,rigid,16244,19818,22410,3574,2592,6166,completed
6324,rigid,16244,19818,22410,3574,2592,6166,completed
6325,rigid,16244,19818,22410,3574,2592,6166,completed
6326,rigid,16244,19818,22410,3574,2592,6166,completed
6327,rigid,16244,19818,22410,3574,2592,6166,completed
6328,rigid,16244,19818,20852,3574,1034,4608,completed
6329,rigid,16244,19818,21144,3574,1326,4900,completed
6330,rigid,16244,19818,22410,3574,2592,6166,completed
6331,rigid,16244,19818,20715,3574,897,4471,completed
6332,rigid,16244,19818,22410,3574,2592,6166,completed
6333,rigid,16244,19818,22410,3574,2592,6166,completed
6334,rigid,16244,19818,20630,3574,812,4386,completed
6335,rigid,16244,19818,22410,3574,2592,6166,completed
6336,rigid,16244,19818,19950,3574,132,3706,completed
6337,rigid,16244,19821,19959,3577,138,3715,completed
6338,rigid,16244,19830,19977,3586,147,3733,completed
6339,rigid,16244,19834,22426,3590,2592,6182,completed
6340,rigid,16244,19834,22426,3590,2592,6182,completed
6341,rigid,16244,19834,20374,3590,540,4130,completed
6342,rigid,16244,19834,20003,3590,169,3759,completed
6343,rigid,16244,19841,20173,3597,332,3929,completed
6344,rigid,16244,19845,21329,3601,1484,5085,completed
6345,rigid,16244,19848,20677,3604,829,4433,completed
6346,rigid,16244,19852,20425,3608,573,4181,completed
6347,rigid,16244,19856,22448,3612,2592,6204,completed
6348,rigid,16244,19857,21420,3613,1563,5176,completed
6349,rigid,16244,19857,20054,3613,197,3810,completed
6350,rigid,16244,19857,22449,3613,2592,6205,completed
6351,rigid,16244,19857,22212,3613,2355,5968,completed
6352,rigid,16244,19857,20697,3613,840,4453,completed
6353,rigid,16244,19857,22449,3613,2592,6205,completed
6354,rigid,16249,19860,21588,3611,1728,5339,completed
6355,rigid,16250,19864,19899,3614,35,3649,completed
6356,rigid,16250,19867,21595,3617,1728,5345,completed
6357,rigid,16251,19869,21597,3618,1728,5346,completed
6358,rigid,16253,19869,21597,3616,1728,5344,completed
6359,rigid,16254,19869,19919,3615,50,3665,completed
6360,rigid,16254,19869,21597,3615,1728,5343,completed
6361,rigid,16256,19883,21611,3627,1728,5355,completed
6362,rigid,16257,19883,21611,3626,1728,5354,completed
6363,rigid,16257,19883,19979,3626,96,3722,completed
6364,rigid,16258,19883,21611,3625,1728,5353,completed
6365,rigid,16258,19883,19904,3625,21,3646,completed
6366,rigid,16258,19889,19910,3631,21,3652,completed
6367,rigid,16258,19890,19911,3632,21,3653,completed
6368,rigid,16258,19899,19920,3641,21,3662,completed
6369,rigid,16258,19899,19920,3641,21,3662,completed
6370,rigid,16258,19902,19923,3644,21,3665,completed
6371,rigid,16258,19904,19925,3646,21,3667,completed
6372,rigid,16258,19904,19925,3646,21,3667,completed
6373,rigid,16261,19906,22704,3645,2798,6443,completed
6374,rigid,16264,19906,20513,3642,607,4249,completed
6375,rigid,16264,19906,20516,3642,610,4252,completed
6376,rigid,16264,19906,20950,3642,1044,4686,completed
6377,rigid,16265,19909,20643,3644,734,4378,completed
6378,rigid,16265,19909,20915,3644,1006,4650,completed
6379,rigid,16265,19909,21185,3644,1276,4920,completed
6380,rigid,16265,19909,20983,3644,1074,4718,completed
6381,rigid,16265,19909,20989,3644,1080,4724,completed
6382,rigid,16265,19909,20894,3644,985,4629,completed
6383,rigid,16265,19910,20820,3645,910,4555,completed
6384,rigid,16265,19911,20372,3646,461,4107,completed
6385,rigid,16265,19917,20747,3652,830,4482,completed
6386,rigid,16266,19920,20489,3654,569,4223,completed
6387,rigid,16266,19920,20305,3654,385,4039,completed
6388,rigid,16266,19923,19952,3657,29,3686,completed
6389,rigid,16285,19925,19980,3640,55,3695,completed
6390,rigid,16286,19925,19931,3639,6,3645,completed
6391,rigid,16286,19931,19936,3645,5,3650,completed
6392,rigid,16286,19931,19943,3645,12,3657,completed
6393,rigid,16286,19936,19941,3650,5,3655,completed
6394,rigid,16286,19941,19953,3655,12,3667,completed
6395,rigid,16286,19943,19955,3657,12,3669,completed
6396,rigid,16286,19948,19960,3662,12,3674,completed
6397,rigid,16286,19948,19960,3662,12,3674,completed
6398,rigid,16299,19948,21135,3649,1187,4836,completed
6399,rigid,16299,19948,21049,3649,1101,4750,completed
6400,rigid,16299,19950,21007,3651,1057,4708,completed
6401,rigid,16299,19952,21064,3653,1112,4765,completed
6402,rigid,16299,19953,20860,3654,907,4561,completed
6403,rigid,16299,19955,21010,3656,1055,4711,completed
6404,rigid,16299,19959,20870,3660,911,4571,completed
6405,rigid,16299,19959,20663,3660,704,4364,completed
6406,rigid,16299,19960,20383,3661,423,4084,completed
6407,rigid,16299,19960,20465,3661,505,4166,completed
6408,rigid,16299,19968,20568,3669,600,4269,completed
6409,rigid,16299,19972,20985,3673,1013,4686,completed
6410,rigid,16299,19973,21085,3674,1112,4786,completed
6411,rigid,16299,19975,21034,3676,1059,4735,completed
6412,rigid,16299,19977,20480,3678,503,4181,completed
6413,rigid,16299,19979,20927,3680,948,4628,completed
6414,rigid,16299,19980,21712,3681,1732,5413,completed
6415,rigid,16299,19980,21074,3681,1094,4775,completed
6416,rigid,16299,19987,20827,3688,840,4528,completed
6417,rigid,16299,20003,21290,3704,1287,4991,completed
6418,rigid,16299,20007,20924,3708,917,4625,completed
6419,rigid,16299,20007,20746,3708,739,4447,completed
6420,rigid,16299,20007,20675,3708,668,4376,completed
6421,rigid,16299,20007,20868,3708,861,4569,completed
6422,rigid,16301,20007,20009,3706,2,3708,completed
6423,rigid,16320,20007,20033,3687,26,3713,completed
6424,rigid,16324,20007,20104,3683,97,3780,completed
6425,rigid,16324,20007,20059,3683,52,3735,completed
6426,rigid,16326,20007,20034,3681,27,3708,completed
6427,rigid,16328,20007,20056,3679,49,3728,completed
6428,rigid,16328,20007,20760,3679,753,4432,completed
6429,rigid,16329,20007,20009,3678,2,3680,completed
6430,rigid,16351,20009,21624,3658,1615,5273,completed
6431,rigid,16357,20009,20128,3652,119,3771,completed
6432,rigid,16368,20009,20023,3641,14,3655,completed
6433,rigid,16368,20009,20023,3641,14,3655,completed
6434,rigid,16368,20009,20023,3641,14,3655,completed
6435,rigid,16368,20009,20029,3641,20,3661,completed
6436,rigid,16368,20012,20026,3644,14,3658,completed
6437,rigid,16368,20023,20037,3655,14,3669,completed
6438,rigid,16368,20023,20037,3655,14,3669,completed
6439,rigid,16368,20023,20037,3655,14,3669,completed
6440,rigid,16368,20026,20040,3658,14,3672,completed
6441,rigid,16368,20028,20042,3660,14,3674,completed
6442,rigid,16368,20029,20043,3661,14,3675,completed
6443,rigid,16368,20029,20043,3661,14,3675,completed
6444,rigid,16368,20031,20045,3663,14,3677,completed
6445,rigid,16368,20033,20047,3665,14,3679,completed
6446,rigid,16368,20034,20048,3666,14,3680,completed
6447,rigid,16368,20035,20049,3667,14,3681,completed
6448,rigid,16370,20037,22727,3667,2690,6357,completed
6449,rigid,16370,20042,20044,3672,2,3674,completed
6450,rigid,16370,20043,22420,3673,2377,6050,completed
6451,rigid,16373,20043,20070,3670,27,3697,completed
6452,rigid,16373,20044,20064,3671,20,3691,completed
6453,rigid,16379,20044,20046,3665,2,3667,completed
6454,rigid,16380,20044,20944,3664,900,4564,completed
6455,rigid,16380,20044,22994,3664,2950,6614,completed
6456,rigid,16380,20044,22251,3664,2207,5871,completed
6457,rigid,16380,20044,23500,3664,3456,7120,completed
6458,rigid,16380,20044,23050,3664,3006,6670,completed
6459,rigid,16380,20044,23500,3664,3456,7120,completed
6460,rigid,16380,20044,23500,3664,3456,7120,completed
6461,rigid,16380,20044,23500,3664,3456,7120,completed
6462,rigid,16380,20044,23500,3664,3456,7120,completed
6463,rigid,16380,20044,23500,3664,3456,7120,completed
6464,rigid,16380,20044,23500,3664,3456,7120,completed
6465,rigid,16380,20044,22095,3664,2051,5715,completed
6466,rigid,16380,20044,23500,3664,3456,7120,completed
6467,rigid,16380,20044,21408,3664,1364,5028,completed
6468,rigid,16380,20044,23500,3664,3456,7120,completed
6469,rigid,16380,20044,23500,3664,3456,7120,completed
6470,rigid,16380,20044,23500,3664,3456,7120,completed
6471,rigid,16380,20044,23500,3664,3456,7120,completed
6472,rigid,16380,20044,21943,3664,1899,5563,completed
6473,rigid,16380,20044,23500,3664,3456,7120,completed
6474,rigid,16380,20044,21931,3664,1887,5551,completed
6475,rigid,16380,20044,21930,3664,1886,5550,completed
6476,rigid,16380,20044,22216,3664,2172,5836,completed
6477,rigid,16380,20044,21363,3664,1319,4983,completed
6478,rigid,16380,20044,21333,3664,1289,4953,completed
6479,rigid,16380,20044,21358,3664,1314,4978,completed
6480,rigid,16380,20044,21364,3664,1320,4984,completed
6481,rigid,16380,20044,21388,3664,1344,5008,completed
6482,rigid,16380,20044,21394,3664,1350,5014,completed
6483,rigid,16380,20044,23500,3664,3456,7120,completed
6484,rigid,16380,20044,23500,3664,3456,7120,completed
6485,rigid,16380,20044,23500,3664,3456,7120,completed
6486,rigid,16380,20044,23500,3664,3456,7120,completed
6487,rigid,16380,20044,23500,3664,3456,7120,completed
6488,rigid,16380,20044,23500,3664,3456,7120,completed
6489,rigid,16380,20044,21406,3664,1362,5026,completed
6490,rigid,16380,20044,23500,3664,3456,7120,completed
6491,rigid,16380,20044,23500,3664,3456,7120,completed
6492,rigid,16380,20044,23500,3664,3456,7120,completed
6493,rigid,16380,20044,23500,3664,3456,7120,completed
6494,rigid,16380,20044,21420,3664,1376,5040,completed
6495,rigid,16380,20044,21078,3664,1034,4698,completed
6496,rigid,16380,20044,20771,3664,727,4391,completed
6497,rigid,16380,20044,20945,3664,901,4565,completed
6498,rigid,16380,20044,20874,3664,830,4494,completed
6499,rigid,16390,20044,20071,3654,27,3681,completed
6500,rigid,16392,20046,20048,3654,2,3656,completed
6501,rigid,16406,20046,20048,3640,2,3642,completed
6502,rigid,16407,20046,20051,3639,5,3644,completed
6503,rigid,16417,20046,20074,3629,28,3657,completed
6504,rigid,16422,20046,20048,3624,2,3626,completed
6505,rigid,16422,20046,20048,3624,2,3626,completed
6506,rigid,16423,20046,20107,3623,61,3684,completed
6507,rigid,16426,20046,21585,3620,1539,5159,completed
6508,rigid,16428,20046,20048,3618,2,3620,completed
6509,rigid,16438,20046,20677,3608,631,4239,completed
6510,rigid,16445,20047,23647,3602,3600,7202,completed
6511,rigid,16454,20047,23647,3593,3600,7193,completed
6512,rigid,16456,20048,20117,3592,69,3661,completed
6513,rigid,16456,20048,20142,3592,94,3686,completed
6514,rigid,16456,20048,20178,3592,130,3722,completed
6515,rigid,16456,20048,20156,3592,108,3700,completed
6516,rigid,16456,20048,20156,3592,108,3700,completed
6517,rigid,16456,20051,20155,3595,104,3699,completed
6518,rigid,16456,20058,20172,3602,114,3716,completed
6519,rigid,16456,20064,20181,3608,117,3725,completed
6520,rigid,16456,20074,20189,3618,115,3733,completed
6521,rigid,16456,20107,20235,3651,128,3779,completed
6522,rigid,16456,20117,20219,3661,102,3763,completed
6523,rigid,16467,20117,20160,3650,43,3693,completed
6524,rigid,16468,20117,20981,3649,864,4513,completed
6525,rigid,16469,20128,20130,3659,2,3661,completed
6526,rigid,16477,20130,20169,3653,39,3692,completed
6527,rigid,16477,20130,20226,3653,96,3749,completed
6528,rigid,16477,20130,20175,3653,45,3698,completed
6529,rigid,16477,20130,20189,3653,59,3712,completed
6530,rigid,16477,20134,20238,3657,104,3761,completed
6531,rigid,16477,20142,20248,3665,106,3771,completed
6532,rigid,16477,20142,20163,3665,21,3686,completed
6533,rigid,16477,20142,20260,3665,118,3783,completed
6534,rigid,16477,20142,20463,3665,321,3986,completed
6535,rigid,16484,20146,20198,3662,52,3714,completed
6536,rigid,16484,20155,20214,3671,59,3730,completed
6537,rigid,16484,20155,20231,3671,76,3747,completed
6538,rigid,16484,20155,20220,3671,65,3736,completed
6539,rigid,16484,20155,20190,3671,35,3706,completed
6540,rigid,16484,20156,20204,3672,48,3720,completed
6541,rigid,16484,20156,20198,3672,42,3714,completed
6542,rigid,16484,20156,20315,3672,159,3831,completed
6543,rigid,16484,20156,20215,3672,59,3731,completed
6544,rigid,16484,20156,20197,3672,41,3713,completed
6545,rigid,16495,20156,20158,3661,2,3663,completed
6546,rigid,16507,20156,20245,3649,89,3738,completed
6547,rigid,16508,20172,20604,3664,432,4096,completed
6548,rigid,16508,20178,20610,3670,432,4102,completed
6549,rigid,16508,20189,20621,3681,432,4113,completed
6550,rigid,16508,20198,20630,3690,432,4122,completed
6551,rigid,16508,20219,20651,3711,432,4143,completed
6552,rigid,16508,20235,20667,3727,432,4159,completed
6553,rigid,16534,20260,20634,3726,374,4100,completed
6554,rigid,16538,20269,20344,3731,75,3806,completed
6555,rigid,16555,20290,21168,3735,878,4613,completed
6556,rigid,16555,20311,21834,3756,1523,5279,completed
6557,rigid,16555,20326,21193,3771,867,4638,completed
6558,rigid,16555,20326,21644,3771,1318,5089,completed
6559,rigid,16555,20326,21331,3771,1005,4776,completed
6560,rigid,16555,20326,21570,3771,1244,5015,completed
6561,rigid,16555,20326,21664,3771,1338,5109,completed
6562,rigid,16555,20337,21380,3782,1043,4825,completed
6563,rigid,16555,20344,22103,3789,1759,5548,completed
6564,rigid,16555,20383,21793,3828,1410,5238,completed
6565,rigid,16556,20402,20980,3846,578,4424,completed
6566,rigid,16556,20414,22133,3858,1719,5577,completed
6567,rigid,16556,20430,21008,3874,578,4452,completed
6568,rigid,16556,20481,21207,3925,726,4651,completed
6569,rigid,16556,20512,21959,3956,1447,5403,completed
6570,rigid,16556,20520,21842,3964,1322,5286,completed
6571,rigid,16613,20604,22049,3991,1445,5436,completed
6572,rigid,16672,20610,21456,3938,846,4784,completed
6573,rigid,16682,20610,20612,3928,2,3930,completed
6574,rigid,16683,20610,25892,3927,5282,9209,completed
6575,rigid,16685,20610,20612,3925,2,3927,completed
6576,rigid,16686,20612,20614,3926,2,3928,completed
6577,rigid,16688,20612,20614,3924,2,3926,completed
6578,rigid,16768,20614,20618,3846,4,3850,completed
6579,rigid,16834,20614,20616,3780,2,3782,completed
6580,rigid,16836,20616,20617,3780,1,3781,completed
6581,rigid,16836,20617,20618,3781,1,3782,completed
6582,rigid,16836,20618,20619,3782,1,3783,completed
6583,rigid,16836,20618,20619,3782,1,3783,completed
6584,rigid,16836,20619,20620,3783,1,3784,completed
6585,rigid,16837,20620,20621,3783,1,3784,completed
6586,rigid,16837,20621,20623,3784,2,3786,completed
6587,rigid,16837,20621,20622,3784,1,3785,completed
6588,rigid,16837,20621,20622,3784,1,3785,completed
6589,rigid,16837,20621,20622,3784,1,3785,completed
6590,rigid,16837,20621,20622,3784,1,3785,completed
6591,rigid,16844,20621,20623,3777,2,3779,completed
6592,rigid,16844,20621,20622,3777,1,3778,completed
6593,rigid,16844,20621,20622,3777,1,3778,completed
6594,rigid,16844,20621,20622,3777,1,3778,completed
6595,rigid,16844,20622,20623,3778,1,3779,completed
6596,rigid,16859,20622,20624,3763,2,3765,completed
6597,rigid,16860,20622,20623,3762,1,3763,completed
6598,rigid,16860,20622,20623,3762,1,3763,completed
6599,rigid,16860,20622,20623,3762,1,3763,completed
6600,rigid,16861,20622,20623,3761,1,3762,completed
6601,rigid,16861,20622,20623,3761,1,3762,completed
6602,rigid,16877,20623,21303,3746,680,4426,completed
6603,rigid,16883,20623,21281,3740,658,4398,completed
6604,rigid,16941,20643,22135,3702,1492,5194,completed
6605,rigid,17059,20648,21458,3589,810,4399,completed
6606,rigid,17059,20648,21339,3589,691,4280,completed
6607,rigid,17059,20651,21043,3592,392,3984,completed
6608,rigid,17060,20651,20748,3591,97,3688,completed
6609,rigid,17060,20651,20763,3591,112,3703,completed
6610,rigid,17060,20651,20815,3591,164,3755,completed
6611,rigid,17060,20651,20812,3591,161,3752,completed
6612,rigid,17060,20651,20785,3591,134,3725,completed
6613,rigid,17060,20651,20826,3591,175,3766,completed
6614,rigid,17060,20651,20750,3591,99,3690,completed
6615,rigid,17060,20651,20729,3591,78,3669,completed
6616,rigid,17060,20663,20750,3603,87,3690,completed
6617,rigid,17060,20667,20733,3607,66,3673,completed
6618,rigid,17060,20667,20764,3607,97,3704,completed
6619,rigid,17060,20667,20772,3607,105,3712,completed
6620,rigid,17060,20667,20894,3607,227,3834,completed
6621,rigid,17060,20667,20936,3607,269,3876,completed
6622,rigid,17060,20667,20804,3607,137,3744,completed
6623,rigid,17060,20667,20857,3607,190,3797,completed
6624,rigid,17060,20667,20805,3607,138,3745,completed
6625,rigid,17060,20667,20811,3607,144,3751,completed
6626,rigid,17060,20675,20809,3615,134,3749,completed
6627,rigid,17060,20677,20877,3617,200,3817,completed
6628,rigid,17060,20677,20779,3617,102,3719,completed
6629,rigid,17060,20697,20898,3637,201,3838,completed
6630,rigid,17060,20715,20823,3655,108,3763,completed
6631,rigid,17060,20729,20851,3669,122,3791,completed
6632,rigid,17060,20733,20835,3673,102,3775,completed
6633,rigid,17060,20746,20883,3686,137,3823,completed
6634,rigid,17060,20746,21013,3686,267,3953,completed
6635,rigid,17060,20747,20867,3687,120,3807,completed
6636,rigid,17060,20748,20931,3688,183,3871,completed
6637,rigid,17060,20750,20949,3690,199,3889,completed
6638,rigid,17060,20750,20952,3690,202,3892,completed
6639,rigid,17060,20760,20970,3700,210,3910,completed
6640,rigid,17060,20760,20910,3700,150,3850,completed
6641,rigid,17060,20760,20896,3700,136,3836,completed
6642,rigid,17063,20760,20771,3697,11,3708,completed
6643,rigid,17065,20760,20761,3695,1,3696,completed
6644,rigid,17065,20760,20761,3695,1,3696,completed
6645,rigid,17066,20760,20761,3694,1,3695,completed
6646,rigid,17066,20760,20761,3694,1,3695,completed
6647,rigid,17082,20763,20815,3681,52,3733,completed
6648,rigid,17085,20764,21028,3679,264,3943,completed
6649,rigid,17093,20772,20777,3679,5,3684,completed
6650,rigid,17108,20777,21353,3669,576,4245,completed
6651,rigid,17108,20777,21353,3669,576,4245,completed
6652,rigid,17109,20789,20790,3680,1,3681,completed
6653,rigid,17111,20790,21049,3679,259,3938,completed
6654,rigid,17111,20790,20949,3679,159,3838,completed
6655,rigid,17112,20809,21068,3697,259,3956,completed
6656,rigid,17112,20823,24421,3711,3598,7309,completed
6657,rigid,17112,20827,20860,3715,33,3748,completed
6658,rigid,17117,20835,20899,3718,64,3782,completed
6659,rigid,17119,20860,24656,3741,3796,7537,completed
6660,rigid,17120,20898,21179,3778,281,4059,completed
6661,rigid,17128,20899,21388,3771,489,4260,completed
6662,rigid,17132,20910,20945,3778,35,3813,completed
6663,rigid,17134,20927,21111,3793,184,3977,completed
6664,rigid,17135,20928,21085,3793,157,3950,completed
6665,rigid,17135,20932,21030,3797,98,3895,completed
6666,rigid,17135,20932,20983,3797,51,3848,completed
6667,rigid,17136,20940,21235,3804,295,4099,completed
6668,rigid,17141,20945,24110,3804,3165,6969,completed
6669,rigid,17144,20945,20995,3801,50,3851,completed
6670,rigid,17161,20949,21334,3788,385,4173,completed
6671,rigid,17161,20949,21341,3788,392,4180,completed
6672,rigid,17161,20949,21367,3788,418,4206,completed
6673,rigid,17161,20950,21438,3789,488,4277,completed
6674,rigid,17161,20952,21445,3791,493,4284,completed
6675,rigid,17161,20952,21460,3791,508,4299,completed
6676,rigid,17161,20952,21454,3791,502,4293,completed
6677,rigid,17161,20952,21359,3791,407,4198,completed
6678,rigid,17161,20970,21422,3809,452,4261,completed
6679,rigid,17161,20971,21375,3810,404,4214,completed
6680,rigid,17161,20971,21436,3810,465,4275,completed
6681,rigid,17161,20971,21370,3810,399,4209,completed
6682,rigid,17163,20980,21089,3817,109,3926,completed
6683,rigid,17163,20980,21076,3817,96,3913,completed
6684,rigid,17163,20980,21075,3817,95,3912,completed
6685,rigid,17163,20980,21056,3817,76,3893,completed
6686,rigid,17163,20980,21066,3817,86,3903,completed
6687,rigid,17163,20981,21143,3818,162,3980,completed
6688,rigid,17163,20983,21140,3820,157,3977,completed
6689,rigid,17163,20983,21115,3820,132,3952,completed
6690,rigid,17163,20985,21158,3822,173,3995,completed
6691,rigid,17163,20989,21092,3826,103,3929,completed
6692,rigid,17163,20989,21209,3826,220,4046,completed
6693,rigid,17163,20995,21255,3832,260,4092,completed
6694,rigid,17163,21007,21143,3844,136,3980,completed
6695,rigid,17163,21008,21194,3845,186,4031,completed
6696,rigid,17163,21008,21146,3845,138,3983,completed
6697,rigid,17163,21008,21152,3845,144,3989,completed
6698,rigid,17163,21008,21137,3845,129,3974,completed
6699,rigid,17163,21010,21074,3847,64,3911,completed
6700,rigid,17163,21013,21107,3850,94,3944,completed
6701,rigid,17163,21028,21225,3865,197,4062,completed
6702,rigid,17163,21028,21129,3865,101,3966,completed
6703,rigid,17163,21030,21227,3867,197,4064,completed
6704,rigid,17163,21034,21141,3871,107,3978,completed
6705,rigid,17163,21043,21162,3880,119,3999,completed
6706,rigid,17163,21049,21148,3886,99,3985,completed
6707,rigid,17163,21049,21182,3886,133,4019,completed
6708,rigid,17163,21049,21300,3886,251,4137,completed
6709,rigid,17163,21049,21168,3886,119,4005,completed
6710,rigid,17163,21049,21227,3886,178,4064,completed
6711,rigid,17163,21049,21241,3886,192,4078,completed
6712,rigid,17163,21049,21244,3886,195,4081,completed
6713,rigid,17163,21056,21261,3893,205,4098,completed
6714,rigid,17163,21064,21212,3901,148,4049,completed
6715,rigid,17163,21066,21200,3903,134,4037,completed
6716,rigid,17166,21068,22796,3902,1728,5630,completed
6717,rigid,17170,21074,22802,3904,1728,5632,completed
6718,rigid,17174,21075,22803,3901,1728,5629,completed
6719,rigid,17179,21111,22265,3932,1154,5086,completed
6720,rigid,17181,21141,22771,3960,1630,5590,completed
6721,rigid,17186,21168,22223,3982,1055,5037,completed
6722,rigid,17186,21168,21871,3982,703,4685,completed
6723,rigid,17190,21174,22772,3984,1598,5582,completed
6724,rigid,17196,21179,21213,3983,34,4017,completed
6725,rigid,17196,21179,21196,3983,17,4000,completed
6726,rigid,17197,21179,22221,3982,1042,5024,completed
6727,rigid,17197,21179,21788,3982,609,4591,completed
6728,rigid,17197,21179,22178,3982,999,4981,completed
6729,rigid,17199,21179,21180,3980,1,3981,completed
6730,rigid,17199,21179,21180,3980,1,3981,completed
6731,rigid,17199,21179,21180,3980,1,3981,completed
6732,rigid,17199,21179,21180,3980,1,3981,completed
6733,rigid,17199,21179,21180,3980,1,3981,completed
6734,rigid,17199,21179,21180,3980,1,3981,completed
6735,rigid,17200,21179,21633,3979,454,4433,completed
6736,rigid,17204,21179,21276,3975,97,4072,completed
6737,rigid,17204,21179,21291,3975,112,4087,completed
6738,rigid,17204,21179,21343,3975,164,4139,completed
6739,rigid,17204,21180,21278,3976,98,4074,completed
6740,rigid,17204,21182,21340,3978,158,4136,completed
6741,rigid,17204,21185,21319,3981,134,4115,completed
6742,rigid,17204,21193,21366,3989,173,4162,completed
6743,rigid,17204,21193,21297,3989,104,4093,completed
6744,rigid,17204,21193,21416,3989,223,4212,completed
6745,rigid,17204,21193,21459,3989,266,4255,completed
6746,rigid,17204,21194,21330,3990,136,4126,completed
6747,rigid,17204,21196,21384,3992,188,4180,completed
6748,rigid,17204,21196,21335,3992,139,4131,completed
6749,rigid,17204,21200,21277,3996,77,4073,completed
6750,rigid,17204,21207,21294,4003,87,4090,completed
6751,rigid,17204,21207,21354,4003,147,4150,completed
6752,rigid,17204,21207,21339,4003,132,4135,completed
6753,rigid,17204,21207,21404,4003,197,4200,completed
6754,rigid,17204,21207,21308,4003,101,4104,completed
6755,rigid,17204,21209,21274,4005,65,4070,completed
6756,rigid,17204,21212,21308,4008,96,4104,completed
6757,rigid,17204,21213,21410,4009,197,4206,completed
6758,rigid,17204,21213,21320,4009,107,4116,completed
6759,rigid,17204,21213,21334,4009,121,4130,completed
6760,rigid,17204,21213,21313,4009,100,4109,completed
6761,rigid,17204,21225,21360,4021,135,4156,completed
6762,rigid,17204,21227,21479,4023,252,4275,completed
6763,rigid,17204,21227,21347,4023,120,4143,completed
6764,rigid,17204,21230,21409,4026,179,4205,completed
6765,rigid,17204,21230,21425,4026,195,4221,completed
6766,rigid,17204,21235,21433,4031,198,4229,completed
6767,rigid,17204,21235,21441,4031,206,4237,completed
6768,rigid,17204,21235,21383,4031,148,4179,completed
6769,rigid,17204,21235,21370,4031,135,4166,completed
6770,rigid,17208,21235,21236,4027,1,4028,completed
6771,rigid,17208,21235,21236,4027,1,4028,completed
6772,rigid,17208,21235,21236,4027,1,4028,completed
6773,rigid,17208,21235,21236,4027,1,4028,completed
6774,rigid,17208,21235,21236,4027,1,4028,completed
6775,rigid,17208,21235,21236,4027,1,4028,completed
6776,rigid,17218,21241,21250,4023,9,4032,completed
6777,rigid,17222,21244,21631,4022,387,4409,completed
6778,rigid,17222,21250,21872,4028,622,4650,completed
6779,rigid,17222,21250,22274,4028,1024,5052,completed
6780,rigid,17222,21252,21380,4030,128,4158,completed
6781,rigid,17234,21276,21746,4042,470,4512,completed
6782,rigid,17243,21277,22375,4034,1098,5132,completed
6783,rigid,17243,21278,22122,4035,844,4879,completed
6784,rigid,17243,21281,22272,4038,991,5029,completed
6785,rigid,17244,21281,21286,4037,5,4042,completed
6786,rigid,17246,21294,25052,4048,3758,7806,completed
6787,rigid,17258,21303,21337,4045,34,4079,completed
6788,rigid,17262,21303,21375,4041,72,4113,completed
6789,rigid,17265,21308,21411,4043,103,4146,completed
6790,rigid,17270,21313,21318,4043,5,4048,completed
6791,rigid,17282,21318,21873,4036,555,4591,completed
6792,rigid,17282,21319,22666,4037,1347,5384,completed
6793,rigid,17282,21320,22544,4038,1224,5262,completed
6794,rigid,17290,21329,21426,4039,97,4136,completed
6795,rigid,17290,21330,21428,4040,98,4138,completed
6796,rigid,17290,21331,21410,4041,79,4120,completed
6797,rigid,17290,21331,21418,4041,87,4128,completed
6798,rigid,17290,21331,21396,4041,65,4106,completed
6799,rigid,17290,21331,21428,4041,97,4138,completed
6800,rigid,17290,21331,21444,4041,113,4154,completed
6801,rigid,17290,21334,21499,4044,165,4209,completed
6802,rigid,17290,21334,21496,4044,162,4206,completed
6803,rigid,17290,21335,21469,4045,134,4179,completed
6804,rigid,17290,21337,21512,4047,175,4222,completed
6805,rigid,17290,21337,21442,4047,105,4152,completed
6806,rigid,17290,21337,21563,4047,226,4273,completed
6807,rigid,17290,21337,21607,4047,270,4317,completed
6808,rigid,17290,21339,21477,4049,138,4187,completed
6809,rigid,17290,21339,21528,4049,189,4238,completed
6810,rigid,17290,21340,21478,4050,138,4188,completed
6811,rigid,17290,21341,21485,4051,144,4195,completed
6812,rigid,17290,21343,21477,4053,134,4187,completed
6813,rigid,17290,21346,21547,4056,201,4257,completed
6814,rigid,17290,21346,21448,4056,102,4158,completed
6815,rigid,17290,21347,21548,4057,201,4258,completed
6816,rigid,17290,21353,21461,4063,108,4171,completed
6817,rigid,17290,21353,21476,4063,123,4186,completed
6818,rigid,17290,21354,21456,4064,102,4166,completed
6819,rigid,17290,21359,21495,4069,136,4205,completed
6820,rigid,17290,21360,21615,4070,255,4325,completed
6821,rigid,17290,21366,21486,4076,120,4196,completed
6822,rigid,17290,21367,21549,4077,182,4259,completed
6823,rigid,17290,21370,21569,4080,199,4279,completed
6824,rigid,17290,21370,21573,4080,203,4283,completed
6825,rigid,17290,21375,21585,4085,210,4295,completed
6826,rigid,17290,21375,21526,4085,151,4236,completed
6827,rigid,17290,21380,21516,4090,136,4226,completed
6828,rigid,17290,21380,27140,4090,5760,9850,completed
6829,rigid,17293,21380,23009,4087,1629,5716,completed
6830,rigid,17293,21380,22497,4087,1117,5204,completed
6831,rigid,17293,21380,21918,4087,538,4625,completed
6832,rigid,17300,21383,44101,4083,22718,26801,completed
6833,rigid,17306,21384,21826,4078,442,4520,completed
6834,rigid,17306,21388,21955,4082,567,4649,completed
6835,rigid,17306,21388,21762,4082,374,4456,completed
6836,rigid,17316,21388,22555,4072,1167,5239,completed
6837,rigid,17316,21388,21785,4072,397,4469,completed
6838,rigid,17316,21388,22492,4072,1104,5176,completed
6839,rigid,17317,21404,21432,4087,28,4115,completed
6840,rigid,17324,21404,21407,4080,3,4083,completed
6841,rigid,17324,21404,21405,4080,1,4081,completed
6842,rigid,17325,21407,21408,4082,1,4083,completed
6843,rigid,17325,21408,21416,4083,8,4091,completed
6844,rigid,17325,21409,21417,4084,8,4092,completed
6845,rigid,17325,21409,21417,4084,8,4092,completed
6846,rigid,17325,21409,21417,4084,8,4092,completed
6847,rigid,17325,21409,21417,4084,8,4092,completed
6848,rigid,17325,21409,21417,4084,8,4092,completed
6849,rigid,17325,21409,21417,4084,8,4092,completed
6850,rigid,17325,21410,21418,4085,8,4093,completed
6851,rigid,17325,21410,21418,4085,8,4093,completed
6852,rigid,17325,21410,21418,4085,8,4093,completed
6853,rigid,17325,21410,21418,4085,8,4093,completed
6854,rigid,17325,21410,21418,4085,8,4093,completed
6855,rigid,17325,21410,21418,4085,8,4093,completed
6856,rigid,17325,21410,21418,4085,8,4093,completed
6857,rigid,17325,21410,21418,4085,8,4093,completed
6858,rigid,17325,21410,21418,4085,8,4093,completed
6859,rigid,17325,21410,21418,4085,8,4093,completed
6860,rigid,17325,21411,21419,4086,8,4094,completed
6861,rigid,17325,21411,21419,4086,8,4094,completed
6862,rigid,17325,21411,21419,4086,8,4094,completed
6863,rigid,17336,21411,21507,4075,96,4171,completed
6864,rigid,17336,21416,21525,4080,109,4189,completed
6865,rigid,17336,21416,21578,4080,162,4242,completed
6866,rigid,17336,21417,21575,4081,158,4239,completed
6867,rigid,17336,21418,21513,4082,95,4177,completed
6868,rigid,17336,21418,21549,4082,131,4213,completed
6869,rigid,17336,21418,21590,4082,172,4254,completed
6870,rigid,17336,21420,21523,4084,103,4187,completed
6871,rigid,17336,21422,21642,4086,220,4306,completed
6872,rigid,17336,21424,21500,4088,76,4164,completed
6873,rigid,17336,21425,21685,4089,260,4349,completed
6874,rigid,17336,21425,21560,4089,135,4224,completed
6875,rigid,17336,21425,21610,4089,185,4274,completed
6876,rigid,17336,21425,21563,4089,138,4227,completed
6877,rigid,17336,21426,21570,4090,144,4234,completed
6878,rigid,17336,21428,21514,4092,86,4178,completed
6879,rigid,17336,21428,21492,4092,64,4156,completed
6880,rigid,17336,21432,21525,4096,93,4189,completed
6881,rigid,17336,21432,21530,4096,98,4194,completed
6882,rigid,17336,21432,21562,4096,130,4226,completed
6883,rigid,17336,21432,21628,4096,196,4292,completed
6884,rigid,17336,21433,21533,4097,100,4197,completed
6885,rigid,17336,21436,21633,4100,197,4297,completed
6886,rigid,17336,21438,21545,4102,107,4209,completed
6887,rigid,17336,21441,21561,4105,120,4225,completed
6888,rigid,17336,21442,21576,4106,134,4240,completed
6889,rigid,17336,21444,21695,4108,251,4359,completed
6890,rigid,17336,21445,21563,4109,118,4227,completed
6891,rigid,17336,21448,21626,4112,178,4290,completed
6892,rigid,17336,21454,21646,4118,192,4310,completed
6893,rigid,17336,21456,21651,4120,195,4315,completed
6894,rigid,17336,21456,21662,4120,206,4326,completed
6895,rigid,17336,21456,21605,4120,149,4269,completed
6896,rigid,17336,21458,21592,4122,134,4256,completed
6897,rigid,17337,21459,21997,4122,538,4660,completed
6898,rigid,17339,21460,21468,4121,8,4129,completed
6899,rigid,17341,21461,21515,4120,54,4174,completed
6900,rigid,17343,21468,22661,4125,1193,5318,completed
6901,rigid,17343,21469,22799,4126,1330,5456,completed
6902,rigid,17343,21476,22558,4133,1082,5215,completed
6903,rigid,17352,21477,21480,4125,3,4128,completed
6904,rigid,17356,21480,21482,4124,2,4126,completed
6905,rigid,17357,21480,21507,4123,27,4150,completed
6906,rigid,17359,21482,21483,4123,1,4124,completed
6907,rigid,17361,21483,21485,4122,2,4124,completed
6908,rigid,17362,21485,22796,4123,1311,5434,completed
6909,rigid,17362,21485,22845,4123,1360,5483,completed
6910,rigid,17362,21485,22389,4123,904,5027,completed
6911,rigid,17362,21486,22134,4124,648,4772,completed
6912,rigid,17362,21492,22698,4130,1206,5336,completed
6913,rigid,17362,21495,22158,4133,663,4796,completed
6914,rigid,17363,21496,22742,4133,1246,5379,completed
6915,rigid,17363,21499,22623,4136,1124,5260,completed
6916,rigid,17363,21500,23034,4137,1534,5671,completed
6917,rigid,17368,21507,21604,4139,97,4236,completed
6918,rigid,17368,21507,21604,4139,97,4236,completed
6919,rigid,17368,21512,21589,4144,77,4221,completed
6920,rigid,17368,21513,21600,4145,87,4232,completed
6921,rigid,17368,21514,21579,4146,65,4211,completed
6922,rigid,17368,21515,21611,4147,96,4243,completed
6923,rigid,17368,21516,21628,4148,112,4260,completed
6924,rigid,17368,21520,21684,4152,164,4316,completed
6925,rigid,17368,21523,21683,4155,160,4315,completed
6926,rigid,17368,21525,21659,4157,134,4291,completed
6927,rigid,17368,21525,21698,4157,173,4330,completed
6928,rigid,17368,21526,21630,4158,104,4262,completed
6929,rigid,17368,21528,21752,4160,224,4384,completed
6930,rigid,17368,21530,21795,4162,265,4427,completed
6931,rigid,17368,21533,21669,4165,136,4301,completed
6932,rigid,17368,21545,21733,4177,188,4365,completed
6933,rigid,17368,21547,21686,4179,139,4318,completed
6934,rigid,17368,21548,21694,4180,146,4326,completed
6935,rigid,17368,21549,21681,4181,132,4313,completed
6936,rigid,17368,21549,21746,4181,197,4378,completed
6937,rigid,17368,21560,21661,4192,101,4293,completed
6938,rigid,17368,21561,21757,4193,196,4389,completed
6939,rigid,17368,21562,21669,4194,107,4301,completed
6940,rigid,17368,21563,21685,4195,122,4317,completed
6941,rigid,17368,21563,21663,4195,100,4295,completed
6942,rigid,17368,21563,21698,4195,135,4330,completed
6943,rigid,17368,21569,21819,4201,250,4451,completed
6944,rigid,17368,21570,21690,4202,120,4322,completed
6945,rigid,17368,21570,21749,4202,179,4381,completed
6946,rigid,17368,21570,21765,4202,195,4397,completed
6947,rigid,17368,21570,21770,4202,200,4402,completed
6948,rigid,17368,21570,21775,4202,205,4407,completed
6949,rigid,17368,21570,21718,4202,148,4350,completed
6950,rigid,17368,21573,21709,4205,136,4341,completed
6951,rigid,17369,21575,21582,4206,7,4213,completed
6952,rigid,17369,21575,21582,4206,7,4213,completed
6953,rigid,17369,21575,21581,4206,6,4212,completed
6954,rigid,17369,21575,21583,4206,8,4214,completed
6955,rigid,17369,21575,21583,4206,8,4214,completed
6956,rigid,17369,21575,21581,4206,6,4212,completed
6957,rigid,17369,21575,21584,4206,9,4215,completed
6958,rigid,17369,21575,21583,4206,8,4214,completed
6959,rigid,17369,21575,21581,4206,6,4212,completed
6960,rigid,17369,21575,21583,4206,8,4214,completed
6961,rigid,17369,21575,21583,4206,8,4214,completed
6962,rigid,17369,21575,21583,4206,8,4214,completed
6963,rigid,17369,21575,21583,4206,8,4214,completed
6964,rigid,17369,21575,21582,4206,7,4213,completed
6965,rigid,17369,21575,21582,4206,7,4213,completed
6966,rigid,17369,21575,21583,4206,8,4214,completed
6967,rigid,17369,21575,21584,4206,9,4215,completed
6968,rigid,17369,21575,21583,4206,8,4214,completed
6969,rigid,17369,21575,21583,4206,8,4214,completed
6970,rigid,17369,21575,21583,4206,8,4214,completed
6971,rigid,17369,21575,21583,4206,8,4214,completed
6972,rigid,17369,21575,21581,4206,6,4212,completed
6973,rigid,17369,21575,21583,4206,8,4214,completed
6974,rigid,17369,21575,21583,4206,8,4214,completed
6975,rigid,17369,21575,21583,4206,8,4214,completed
6976,rigid,17369,21575,21582,4206,7,4213,completed
6977,rigid,17369,21575,21583,4206,8,4214,completed
6978,rigid,17369,21575,21583,4206,8,4214,completed
6979,rigid,17369,21575,21583,4206,8,4214,completed
6980,rigid,17369,21575,21584,4206,9,4215,completed
6981,rigid,17369,21575,21583,4206,8,4214,completed
6982,rigid,17369,21575,21584,4206,9,4215,completed
6983,rigid,17369,21576,21584,4207,8,4215,completed
6984,rigid,17369,21576,21584,4207,8,4215,completed
6985,rigid,17369,21576,21584,4207,8,4215,completed
6986,rigid,17369,21576,21584,4207,8,4215,completed
6987,rigid,17369,21576,21582,4207,6,4213,completed
6988,rigid,17369,21576,21584,4207,8,4215,completed
6989,rigid,17369,21576,21584,4207,8,4215,completed
6990,rigid,17369,21576,21584,4207,8,4215,completed
6991,rigid,17369,21576,21584,4207,8,4215,completed
6992,rigid,17369,21576,21584,4207,8,4215,completed
6993,rigid,17369,21576,21584,4207,8,4215,completed
6994,rigid,17369,21576,21584,4207,8,4215,completed
6995,rigid,17369,21576,21584,4207,8,4215,completed
6996,rigid,17369,21576,21584,4207,8,4215,completed
6997,rigid,17369,21576,21585,4207,9,4216,completed
6998,rigid,17369,21576,21582,4207,6,4213,completed
6999,rigid,17369,21576,21580,4207,4,4211,completed
7000,rigid,17369,21576,21582,4207,6,4213,completed
7001,rigid,17369,21576,21582,4207,6,4213,completed
7002,rigid,17369,21576,21582,4207,6,4213,completed
7003,rigid,17369,21576,21582,4207,6,4213,completed
7004,rigid,17369,21576,21582,4207,6,4213,completed
7005,rigid,17369,21576,21582,4207,6,4213,completed
7006,rigid,17369,21576,21582,4207,6,4213,completed
7007,rigid,17369,21576,21582,4207,6,4213,completed
7008,rigid,17369,21576,21582,4207,6,4213,completed
7009,rigid,17369,21576,21583,4207,7,4214,completed
7010,rigid,17369,21576,21582,4207,6,4213,completed
7011,rigid,17369,21576,21582,4207,6,4213,completed
7012,rigid,17369,21576,21582,4207,6,4213,completed
7013,rigid,17369,21576,21582,4207,6,4213,completed
7014,rigid,17369,21576,21582,4207,6,4213,completed
7015,rigid,17369,21578,21584,4209,6,4215,completed
7016,rigid,17369,21578,21584,4209,6,4215,completed
7017,rigid,17369,21578,21584,4209,6,4215,completed
7018,rigid,17369,21578,21584,4209,6,4215,completed
7019,rigid,17369,21578,21584,4209,6,4215,completed
7020,rigid,17369,21578,21585,4209,7,4216,completed
7021,rigid,17369,21578,21584,4209,6,4215,completed
7022,rigid,17369,21578,21582,4209,4,4213,completed
7023,rigid,17369,21578,21584,4209,6,4215,completed
7024,rigid,17369,21578,21584,4209,6,4215,completed
7025,rigid,17369,21578,21584,4209,6,4215,completed
7026,rigid,17369,21578,21584,4209,6,4215,completed
7027,rigid,17369,21578,21584,4209,6,4215,completed
7028,rigid,17369,21578,21584,4209,6,4215,completed
7029,rigid,17369,21578,21584,4209,6,4215,completed
7030,rigid,17369,21578,21584,4209,6,4215,completed
7031,rigid,17369,21578,21585,4209,7,4216,completed
7032,rigid,17369,21578,21584,4209,6,4215,completed
7033,rigid,17369,21578,21584,4209,6,4215,completed
7034,rigid,17369,21578,21584,4209,6,4215,completed
7035,rigid,17369,21578,21584,4209,6,4215,completed
7036,rigid,17369,21578,21584,4209,6,4215,completed
7037,rigid,17369,21578,21584,4209,6,4215,completed
7038,rigid,17369,21578,21584,4209,6,4215,completed
7039,rigid,17369,21578,21582,4209,4,4213,completed
7040,rigid,17369,21578,21584,4209,6,4215,completed
7041,rigid,17369,21578,21584,4209,6,4215,completed
7042,rigid,17369,21578,21584,4209,6,4215,completed
7043,rigid,17369,21578,21584,4209,6,4215,completed
7044,rigid,17369,21578,21584,4209,6,4215,completed
7045,rigid,17369,21578,21584,4209,6,4215,completed
7046,rigid,17369,21578,21584,4209,6,4215,completed
7047,rigid,17369,21579,21585,4210,6,4216,completed
7048,rigid,17369,21579,21585,4210,6,4216,completed
7049,rigid,17369,21579,21585,4210,6,4216,completed
7050,rigid,17369,21579,21585,4210,6,4216,completed
7051,rigid,17369,21579,21585,4210,6,4216,completed
7052,rigid,17369,21579,21585,4210,6,4216,completed
7053,rigid,17369,21579,21585,4210,6,4216,completed
7054,rigid,17369,21579,21585,4210,6,4216,completed
7055,rigid,17369,21579,21585,4210,6,4216,completed
7056,rigid,17369,21579,21585,4210,6,4216,completed
7057,rigid,17369,21579,21583,4210,4,4214,completed
7058,rigid,17369,21579,21585,4210,6,4216,completed
7059,rigid,17369,21579,21585,4210,6,4216,completed
7060,rigid,17369,21579,21585,4210,6,4216,completed
7061,rigid,17369,21579,21585,4210,6,4216,completed
7062,rigid,17369,21579,21585,4210,6,4216,completed
7063,rigid,17369,21579,21585,4210,6,4216,completed
7064,rigid,17369,21579,21585,4210,6,4216,completed
7065,rigid,17369,21579,21586,4210,7,4217,completed
7066,rigid,17369,21579,21585,4210,6,4216,completed
7067,rigid,17369,21579,21586,4210,7,4217,completed
7068,rigid,17369,21579,21584,4210,5,4215,completed
7069,rigid,17369,21579,21584,4210,5,4215,completed
7070,rigid,17369,21579,21584,4210,5,4215,completed
7071,rigid,17369,21579,21585,4210,6,4216,completed
7072,rigid,17369,21579,21586,4210,7,4217,completed
7073,rigid,17369,21579,21586,4210,7,4217,completed
7074,rigid,17369,21579,21586,4210,7,4217,completed
7075,rigid,17369,21579,21586,4210,7,4217,completed
7076,rigid,17369,21579,21585,4210,6,4216,completed
7077,rigid,17369,21579,21586,4210,7,4217,completed
7078,rigid,17369,21579,21585,4210,6,4216,completed
7079,rigid,17369,21580,21587,4211,7,4218,completed
7080,rigid,17369,21581,21588,4212,7,4219,completed
7081,rigid,17369,21581,21588,4212,7,4219,completed
7082,rigid,17369,21581,21588,4212,7,4219,completed
7083,rigid,17369,21581,21588,4212,7,4219,completed
7084,rigid,17369,21582,21589,4213,7,4220,completed
7085,rigid,17369,21582,21589,4213,7,4220,completed
7086,rigid,17369,21582,21587,4213,5,4218,completed
7087,rigid,17369,21582,21587,4213,5,4218,completed
7088,rigid,17369,21582,21589,4213,7,4220,completed
7089,rigid,17369,21582,21589,4213,7,4220,completed
7090,rigid,17369,21582,21589,4213,7,4220,completed
7091,rigid,17369,21582,21589,4213,7,4220,completed
7092,rigid,17369,21582,21589,4213,7,4220,completed
7093,rigid,17369,21582,21589,4213,7,4220,completed
7094,rigid,17369,21582,21589,4213,7,4220,completed
7095,rigid,17369,21582,21589,4213,7,4220,completed
7096,rigid,17369,21582,21587,4213,5,4218,completed
7097,rigid,17369,21582,21589,4213,7,4220,completed
7098,rigid,17369,21582,21588,4213,6,4219,completed
7099,rigid,17369,21582,21587,4213,5,4218,completed
7100,rigid,17369,21582,21589,4213,7,4220,completed
7101,rigid,17369,21582,21589,4213,7,4220,completed
7102,rigid,17369,21582,21589,4213,7,4220,completed
7103,rigid,17369,21582,21589,4213,7,4220,completed
7104,rigid,17369,21582,21589,4213,7,4220,completed
7105,rigid,17369,21582,21589,4213,7,4220,completed
7106,rigid,17369,21582,21589,4213,7,4220,completed
7107,rigid,17369,21583,21589,4214,6,4220,completed
7108,rigid,17369,21583,21590,4214,7,4221,completed
7109,rigid,17369,21583,21590,4214,7,4221,completed
7110,rigid,17369,21583,21588,4214,5,4219,completed
7111,rigid,17369,21583,21589,4214,6,4220,completed
7112,rigid,17369,21583,21588,4214,5,4219,completed
7113,rigid,17369,21583,21590,4214,7,4221,completed
7114,rigid,17369,21583,21589,4214,6,4220,completed
7115,rigid,17369,21583,21590,4214,7,4221,completed
7116,rigid,17369,21583,21590,4214,7,4221,completed
7117,rigid,17369,21583,21590,4214,7,4221,completed
7118,rigid,17369,21583,21590,4214,7,4221,completed
7119,rigid,17369,21583,21589,4214,6,4220,completed
7120,rigid,17369,21583,21590,4214,7,4221,completed
7121,rigid,17369,21583,21590,4214,7,4221,completed
7122,rigid,17369,21583,21590,4214,7,4221,completed
7123,rigid,17369,21583,21591,4214,8,4222,completed
7124,rigid,17369,21583,21591,4214,8,4222,completed
7125,rigid,17369,21583,21592,4214,9,4223,completed
7126,rigid,17369,21583,21592,4214,9,4223,completed
7127,rigid,17369,21583,21591,4214,8,4222,completed
7128,rigid,17369,21584,21592,4215,8,4223,completed
7129,rigid,17369,21584,21592,4215,8,4223,completed
7130,rigid,17369,21584,21592,4215,8,4223,completed
7131,rigid,17369,21584,21590,4215,6,4221,completed
7132,rigid,17369,21584,21591,4215,7,4222,completed
7133,rigid,17369,21584,21591,4215,7,4222,completed
7134,rigid,17369,21584,21591,4215,7,4222,completed
7135,rigid,17369,21584,21591,4215,7,4222,completed
7136,rigid,17369,21584,21589,4215,5,4220,completed
7137,rigid,17369,21584,21591,4215,7,4222,completed
7138,rigid,17369,21584,21591,4215,7,4222,completed
7139,rigid,17369,21584,21589,4215,5,4220,completed
7140,rigid,17369,21584,21591,4215,7,4222,completed
7141,rigid,17369,21584,21590,4215,6,4221,completed
7142,rigid,17369,21584,21591,4215,7,4222,completed
7143,rigid,17369,21584,21591,4215,7,4222,completed
7144,rigid,17369,21584,21590,4215,6,4221,completed
7145,rigid,17369,21584,21590,4215,6,4221,completed
7146,rigid,17369,21584,21591,4215,7,4222,completed
7147,rigid,17369,21584,21591,4215,7,4222,completed
7148,rigid,17369,21584,21591,4215,7,4222,completed
7149,rigid,17369,21584,21590,4215,6,4221,completed
7150,rigid,17369,21584,21591,4215,7,4222,completed
7151,rigid,17373,21585,22867,4212,1282,5494,completed
7152,rigid,17373,21585,22802,4212,1217,5429,completed
7153,rigid,17373,21585,22479,4212,894,5106,completed
7154,rigid,17375,21588,21633,4213,45,4258,completed
7155,rigid,17378,21589,21695,4211,106,4317,completed
7156,rigid,17378,21591,21692,4213,101,4314,completed
7157,rigid,17388,21592,21596,4204,4,4208,completed
7158,rigid,17389,21592,21600,4203,8,4211,completed
7159,rigid,17393,21595,21607,4202,12,4214,completed
7160,rigid,17449,21595,21607,4146,12,4158,completed
7161,rigid,17454,21595,21607,4141,12,4153,completed
7162,rigid,17454,21596,21601,4142,5,4147,completed
7163,rigid,17454,21597,21609,4143,12,4155,completed
7164,rigid,17455,21597,21602,4142,5,4147,completed
7165,rigid,17455,21597,21609,4142,12,4154,completed
7166,rigid,17455,21600,21612,4145,12,4157,completed
7167,rigid,17455,21601,21613,4146,12,4158,completed
7168,rigid,17456,21602,21614,4146,12,4158,completed
7169,rigid,17456,21604,21616,4148,12,4160,completed
7170,rigid,17456,21604,21607,4148,3,4151,completed
7171,rigid,17457,21607,21619,4150,12,4162,completed
7172,rigid,17457,21607,21619,4150,12,4162,completed
7173,rigid,17469,21607,21679,4138,72,4210,completed
7174,rigid,17469,21610,22118,4141,508,4649,completed
7175,rigid,17520,21611,21701,4091,90,4181,completed
7176,rigid,17520,21611,21704,4091,93,4184,completed
7177,rigid,17520,21611,21708,4091,97,4188,completed
7178,rigid,17520,21611,21683,4091,72,4163,completed
7179,rigid,17520,21611,21694,4091,83,4174,completed
7180,rigid,17520,21611,21707,4091,96,4187,completed
7181,rigid,17520,21612,21674,4092,62,4154,completed
7182,rigid,17520,21613,21703,4093,90,4183,completed
7183,rigid,17520,21613,21708,4093,95,4188,completed
7184,rigid,17520,21613,21719,4093,106,4199,completed
7185,rigid,17520,21614,21766,4094,152,4246,completed
7186,rigid,17520,21615,21760,4095,145,4240,completed
7187,rigid,17520,21616,21738,4096,122,4218,completed
7188,rigid,17520,21619,21786,4099,167,4266,completed
7189,rigid,17520,21619,21826,4099,207,4306,completed
7190,rigid,17520,21619,21864,4099,245,4344,completed
7191,rigid,17520,21624,21748,4104,124,4228,completed
7192,rigid,17520,21624,21802,4104,178,4282,completed
7193,rigid,17520,21624,21751,4104,127,4231,completed
7194,rigid,17520,21625,21760,4105,135,4240,completed
7195,rigid,17520,21626,21750,4106,124,4230,completed
7196,rigid,17520,21628,21812,4108,184,4292,completed
7197,rigid,17520,21628,21810,4108,182,4290,completed
7198,rigid,17520,21630,21731,4110,101,4211,completed
7199,rigid,17520,21631,21742,4111,111,4222,completed
7200,rigid,17520,21633,21759,4113,126,4239,completed
7201,rigid,17520,21633,21867,4113,234,4347,completed
7202,rigid,17520,21633,21746,4113,113,4226,completed
7203,rigid,17520,21633,21799,4113,166,4279,completed
7204,rigid,17520,21633,21815,4113,182,4295,completed
7205,rigid,17520,21633,21810,4113,177,4290,completed
7206,rigid,17520,21633,21822,4113,189,4302,completed
7207,rigid,17520,21633,21770,4113,137,4250,completed
7208,rigid,17520,21633,21760,4113,127,4240,completed
7209,rigid,17520,21633,21721,4113,88,4201,completed
7210,rigid,17520,21642,21731,4122,89,4211,completed
7211,rigid,17520,21644,21739,4124,95,4219,completed
7212,rigid,17520,21644,21747,4124,103,4227,completed
7213,rigid,17520,21644,21794,4124,150,4274,completed
7214,rigid,17520,21644,21786,4124,142,4266,completed
7215,rigid,17520,21646,21768,4126,122,4248,completed
7216,rigid,17520,21651,21813,4131,162,4293,completed
7217,rigid,17520,21659,21861,4139,202,4341,completed
7218,rigid,17520,21661,21899,4141,238,4379,completed
7219,rigid,17520,21662,21786,4142,124,4266,completed
7220,rigid,17520,21663,21837,4143,174,4317,completed
7221,rigid,17520,21664,21733,4144,69,4213,completed
7222,rigid,17520,21664,21747,4144,83,4227,completed
7223,rigid,17520,21664,21757,4144,93,4237,completed
7224,rigid,17520,21664,21724,4144,60,4204,completed
7225,rigid,17520,21664,21750,4144,86,4230,completed
7226,rigid,17520,21669,21760,4149,91,4240,completed
7227,rigid,17520,21669,21797,4149,128,4277,completed
7228,rigid,17520,21674,21811,4154,137,4291,completed
7229,rigid,17520,21679,21799,4159,120,4279,completed
7230,rigid,17520,21681,21862,4161,181,4342,completed
7231,rigid,17520,21683,21863,4163,180,4343,completed
7232,rigid,17520,21683,21783,4163,100,4263,completed
7233,rigid,17520,21684,21794,4164,110,4274,completed
7234,rigid,17520,21685,21809,4165,124,4289,completed
7235,rigid,17520,21685,21916,4165,231,4396,completed
7236,rigid,17520,21686,21797,4166,111,4277,completed
7237,rigid,17520,21690,21854,4170,164,4334,completed
7238,rigid,17520,21692,21871,4172,179,4351,completed
7239,rigid,17520,21692,21867,4172,175,4347,completed
7240,rigid,17520,21694,21880,4174,186,4360,completed
7241,rigid,17520,21694,21829,4174,135,4309,completed
7242,rigid,17520,21695,21820,4175,125,4300,completed
7243,rigid,17520,21695,21784,4175,89,4264,completed
7244,rigid,17520,21695,21786,4175,91,4266,completed
7245,rigid,17520,21695,21790,4175,95,4270,completed
7246,rigid,17520,21695,21766,4175,71,4246,completed
7247,rigid,17520,21698,21781,4178,83,4261,completed
7248,rigid,17520,21698,21793,4178,95,4273,completed
7249,rigid,17520,21701,21762,4181,61,4242,completed
7250,rigid,17520,21703,21793,4183,90,4273,completed
7251,rigid,17520,21704,21797,4184,93,4277,completed
7252,rigid,17520,21707,21811,4187,104,4291,completed
7253,rigid,17520,21708,21860,4188,152,4340,completed
7254,rigid,17520,21708,21852,4188,144,4332,completed
7255,rigid,17520,21709,21832,4189,123,4312,completed
7256,rigid,17520,21712,21876,4192,164,4356,completed
7257,rigid,17520,21712,21917,4192,205,4397,completed
7258,rigid,17520,21718,21962,4198,244,4442,completed
7259,rigid,17520,21719,21844,4199,125,4324,completed
7260,rigid,17520,21721,21900,4201,179,4380,completed
7261,rigid,17520,21724,21852,4204,128,4332,completed
7262,rigid,17520,21731,21870,4211,139,4350,completed
7263,rigid,17520,21731,21854,4211,123,4334,completed
7264,rigid,17520,21733,21917,4213,184,4397,completed
7265,rigid,17520,21733,21913,4213,180,4393,completed
7266,rigid,17520,21738,21839,4218,101,4319,completed
7267,rigid,17520,21739,21850,4219,111,4330,completed
7268,rigid,17520,21742,21867,4222,125,4347,completed
7269,rigid,17520,21746,21977,4226,231,4457,completed
7270,rigid,17520,21746,21858,4226,112,4338,completed
7271,rigid,17520,21746,21911,4226,165,4391,completed
7272,rigid,17520,21746,21929,4226,183,4409,completed
7273,rigid,17520,21746,21922,4226,176,4402,completed
7274,rigid,17520,21746,21934,4226,188,4414,completed
7275,rigid,17520,21747,21882,4227,135,4362,completed
7276,rigid,17520,21747,21873,4227,126,4353,completed
7277,rigid,17521,21748,21837,4227,89,4316,completed
7278,rigid,17521,21749,21854,4228,105,4333,completed
7279,rigid,17521,21750,21902,4229,152,4381,completed
7280,rigid,17521,21750,21896,4229,146,4375,completed
7281,rigid,17521,21751,21872,4230,121,4351,completed
7282,rigid,17521,21752,21844,4231,92,4323,completed
7283,rigid,17521,21757,21853,4236,96,4332,completed
7284,rigid,17521,21757,21829,4236,72,4308,completed
7285,rigid,17521,21759,21842,4238,83,4321,completed
7286,rigid,17521,21760,21856,4239,96,4335,completed
7287,rigid,17521,21760,21822,4239,62,4301,completed
7288,rigid,17521,21760,21850,4239,90,4329,completed
7289,rigid,17521,21760,21855,4239,95,4334,completed
7290,rigid,17521,21762,21928,4241,166,4407,completed
7291,rigid,17521,21762,21968,4241,206,4447,completed
7292,rigid,17521,21765,22010,4244,245,4489,completed
7293,rigid,17521,21766,21891,4245,125,4370,completed
7294,rigid,17521,21766,21944,4245,178,4423,completed
7295,rigid,17521,21768,21894,4247,126,4373,completed
7296,rigid,17521,21770,21905,4249,135,4384,completed
7297,rigid,17521,21770,21894,4249,124,4373,completed
7298,rigid,17521,21775,21959,4254,184,4438,completed
7299,rigid,17521,21781,21963,4260,182,4442,completed
7300,rigid,17521,21783,21883,4262,100,4362,completed
7301,rigid,17521,21784,21895,4263,111,4374,completed
7302,rigid,17521,21785,21911,4264,126,4390,completed
7303,rigid,17521,21786,22021,4265,235,4500,completed
7304,rigid,17521,21786,21899,4265,113,4378,completed
7305,rigid,17521,21786,21953,4265,167,4432,completed
7306,rigid,17521,21786,21969,4265,183,4448,completed
7307,rigid,17521,21788,21966,4267,178,4445,completed
7308,rigid,17521,21790,21980,4269,190,4459,completed
7309,rigid,17521,21793,21930,4272,137,4409,completed
7310,rigid,17521,21793,21920,4272,127,4399,completed
7311,rigid,17521,21793,21882,4272,89,4361,completed
7312,rigid,17521,21793,21882,4272,89,4361,completed
7313,rigid,17521,21793,21888,4272,95,4367,completed
7314,rigid,17521,21793,21895,4272,102,4374,completed
7315,rigid,17521,21793,21943,4272,150,4422,completed
7316,rigid,17521,21794,21936,4273,142,4415,completed
7317,rigid,17521,21794,21915,4273,121,4394,completed
7318,rigid,17521,21795,21956,4274,161,4435,completed
7319,rigid,17521,21797,21866,4276,69,4345,completed
7320,rigid,17521,21797,21879,4276,82,4358,completed
7321,rigid,17521,21797,21890,4276,93,4369,completed
7322,rigid,17521,21799,21860,4278,61,4339,completed
7323,rigid,17521,21799,21886,4278,87,4365,completed
7324,rigid,17521,21802,22003,4281,201,4482,completed
7325,rigid,17521,21809,22048,4288,239,4527,completed
7326,rigid,17521,21810,21933,4289,123,4412,completed
7327,rigid,17521,21810,21985,4289,175,4464,completed
7328,rigid,17521,21811,21939,4290,128,4418,completed
7329,rigid,17521,21811,21947,4290,136,4426,completed
7330,rigid,17521,21812,21932,4291,120,4411,completed
7331,rigid,17521,21813,21995,4292,182,4474,completed
7332,rigid,17521,21815,21995,4294,180,4474,completed
7333,rigid,17521,21819,21919,4298,100,4398,completed
7334,rigid,17521,21820,21930,4299,110,4409,completed
7335,rigid,17521,21822,21913,4301,91,4392,completed
7336,rigid,17521,21822,21946,4301,124,4425,completed
7337,rigid,17521,21826,22057,4305,231,4536,completed
7338,rigid,17521,21826,21937,4305,111,4416,completed
7339,rigid,17521,21829,21993,4308,164,4472,completed
7340,rigid,17521,21829,22007,4308,178,4486,completed
7341,rigid,17521,21832,22006,4311,174,4485,completed
7342,rigid,17521,21834,22019,4313,185,4498,completed
7343,rigid,17521,21834,21969,4313,135,4448,completed
7344,rigid,17521,21834,21958,4313,124,4437,completed
7345,rigid,17521,21834,21924,4313,90,4403,completed
7346,rigid,17521,21834,21925,4313,91,4404,completed
7347,rigid,17521,21837,21932,4316,95,4411,completed
7348,rigid,17521,21837,21908,4316,71,4387,completed
7349,rigid,17521,21839,21922,4318,83,4401,completed
7350,rigid,17521,21839,21943,4318,104,4422,completed
7351,rigid,17521,21842,21992,4321,150,4471,completed
7352,rigid,17521,21842,21986,4321,144,4465,completed
7353,rigid,17521,21842,21964,4321,122,4443,completed
7354,rigid,17521,21842,22007,4321,165,4486,completed
7355,rigid,17521,21842,22048,4321,206,4527,completed
7356,rigid,17521,21842,22089,4321,247,4568,completed
7357,rigid,17521,21842,21965,4321,123,4444,completed
7358,rigid,17521,21844,22022,4323,178,4501,completed
7359,rigid,17521,21844,21972,4323,128,4451,completed
7360,rigid,17521,21850,21988,4329,138,4467,completed
7361,rigid,17521,21850,21974,4329,124,4453,completed
7362,rigid,17521,21852,21947,4331,95,4426,completed
7363,rigid,17521,21852,21913,4331,61,4392,completed
7364,rigid,17521,21853,21943,4332,90,4422,completed
7365,rigid,17521,21854,21947,4333,93,4426,completed
7366,rigid,17521,21854,22036,4333,182,4515,completed
7367,rigid,17521,21854,22035,4333,181,4514,completed
7368,rigid,17521,21855,21956,4334,101,4435,completed
7369,rigid,17521,21856,21967,4335,111,4446,completed
7370,rigid,17521,21858,21983,4337,125,4462,completed
7371,rigid,17521,21860,22093,4339,233,4572,completed
7372,rigid,17521,21860,21971,4339,111,4450,completed
7373,rigid,17521,21861,22028,4340,167,4507,completed
7374,rigid,17521,21862,22046,4341,184,4525,completed
7375,rigid,17521,21863,22038,4342,175,4517,completed
7376,rigid,17521,21864,22052,4343,188,4531,completed
7377,rigid,17521,21866,22001,4345,135,4480,completed
7378,rigid,17521,21867,21994,4346,127,4473,completed
7379,rigid,17541,21870,22544,4329,674,5003,completed
7380,rigid,17555,21871,22085,4316,214,4530,completed
7381,rigid,17589,21871,21909,4282,38,4320,completed
7382,rigid,17589,21871,21891,4282,20,4302,completed
7383,rigid,17589,21871,21897,4282,26,4308,completed
7384,rigid,17589,21871,21891,4282,20,4302,completed
7385,rigid,17589,21871,21893,4282,22,4304,completed
7386,rigid,17589,21871,21892,4282,21,4303,completed
7387,rigid,17589,21871,21892,4282,21,4303,completed
7388,rigid,17589,21871,21893,4282,22,4304,completed
7389,rigid,17589,21871,21907,4282,36,4318,completed
7390,rigid,17589,21871,21888,4282,17,4299,completed
7391,rigid,17589,21871,21897,4282,26,4308,completed
7392,rigid,17589,21871,21898,4282,27,4309,completed
7393,rigid,17589,21871,21893,4282,22,4304,completed
7394,rigid,17589,21872,21904,4283,32,4315,completed
7395,rigid,17589,21872,21890,4283,18,4301,completed
7396,rigid,17589,21872,21902,4283,30,4313,completed
7397,rigid,17589,21872,21897,4283,25,4308,completed
7398,rigid,17589,21872,21897,4283,25,4308,completed
7399,rigid,17589,21872,21898,4283,26,4309,completed
7400,rigid,17589,21872,21898,4283,26,4309,completed
7401,rigid,17589,21873,21900,4284,27,4311,completed
7402,rigid,17589,21873,21910,4284,37,4321,completed
7403,rigid,17589,21873,21907,4284,34,4318,completed
7404,rigid,17589,21873,21909,4284,36,4320,completed
7405,rigid,17589,21873,21903,4284,30,4314,completed
7406,rigid,17589,21873,21905,4284,32,4316,completed
7407,rigid,17589,21873,21892,4284,19,4303,completed
7408,rigid,17589,21873,21894,4284,21,4305,completed
7409,rigid,17589,21873,21902,4284,29,4313,completed
7410,rigid,17589,21873,21898,4284,25,4309,completed
7411,rigid,17589,21873,21898,4284,25,4309,completed
7412,rigid,17589,21873,21893,4284,20,4304,completed
7413,rigid,17589,21876,21904,4287,28,4315,completed
7414,rigid,17589,21876,21905,4287,29,4316,completed
7415,rigid,17589,21876,21899,4287,23,4310,completed
7416,rigid,17589,21876,21900,4287,24,4311,completed
7417,rigid,17589,21879,21901,4290,22,4312,completed
7418,rigid,17589,21879,21903,4290,24,4314,completed
7419,rigid,17589,21879,21901,4290,22,4312,completed
7420,rigid,17589,21880,21895,4291,15,4306,completed
7421,rigid,17589,21880,21908,4291,28,4319,completed
7422,rigid,17589,21880,21907,4291,27,4318,completed
7423,rigid,17589,21880,21904,4291,24,4315,completed
7424,rigid,17589,21882,21908,4293,26,4319,completed
7425,rigid,17589,21882,21902,4293,20,4313,completed
7426,rigid,17589,21882,21914,4293,32,4325,completed
7427,rigid,17589,21882,21909,4293,27,4320,completed
7428,rigid,17589,21882,21908,4293,26,4319,completed
7429,rigid,17589,21882,21899,4293,17,4310,completed
7430,rigid,17589,21882,21900,4293,18,4311,completed
7431,rigid,17589,21882,21908,4293,26,4319,completed
7432,rigid,17589,21882,21910,4293,28,4321,completed
7433,rigid,17589,21882,21903,4293,21,4314,completed
7434,rigid,17589,21883,21899,4294,16,4310,completed
7435,rigid,17589,21883,21901,4294,18,4312,completed
7436,rigid,17589,21883,21908,4294,25,4319,completed
7437,rigid,17589,21883,21913,4294,30,4324,completed
7438,rigid,17589,21883,21904,4294,21,4315,completed
7439,rigid,17589,21883,21906,4294,23,4317,completed
7440,rigid,17589,21883,21894,4294,11,4305,completed
7441,rigid,17589,21883,21907,4294,24,4318,completed
7442,rigid,17589,21883,21918,4294,35,4329,completed
7443,rigid,17589,21883,21915,4294,32,4326,completed
7444,rigid,17589,21883,21908,4294,25,4319,completed
7445,rigid,17589,21883,21912,4294,29,4323,completed
7446,rigid,17589,21886,21910,4297,24,4321,completed
7447,rigid,17589,21886,21911,4297,25,4322,completed
7448,rigid,17589,21886,21906,4297,20,4317,completed
7449,rigid,17589,21887,21912,4298,25,4323,completed
7450,rigid,17589,21887,21909,4298,22,4320,completed
7451,rigid,17589,21887,21909,4298,22,4320,completed
7452,rigid,17589,21887,21909,4298,22,4320,completed
7453,rigid,17589,21888,21923,4299,35,4334,completed
7454,rigid,17589,21888,21911,4299,23,4322,completed
7455,rigid,17589,21888,21911,4299,23,4322,completed
7456,rigid,17589,21888,21911,4299,23,4322,completed
7457,rigid,17589,21888,21908,4299,20,4319,completed
7458,rigid,17589,21890,21910,4301,20,4321,completed
7459,rigid,17589,21890,21913,4301,23,4324,completed
7460,rigid,17589,21890,21910,4301,20,4321,completed
7461,rigid,17589,21890,21924,4301,34,4335,completed
7462,rigid,17589,21890,21910,4301,20,4321,completed
7463,rigid,17589,21891,21922,4302,31,4333,completed
7464,rigid,17589,21891,21922,4302,31,4333,completed
7465,rigid,17589,21891,21914,4302,23,4325,completed
7466,rigid,17589,21891,21929,4302,38,4340,completed
7467,rigid,17589,21891,21909,4302,18,4320,completed
7468,rigid,17589,21892,21915,4303,23,4326,completed
7469,rigid,17589,21892,21923,4303,31,4334,completed
7470,rigid,17589,21892,21916,4303,24,4327,completed
7471,rigid,17589,21893,21917,4304,24,4328,completed
7472,rigid,17589,21893,21922,4304,29,4333,completed
7473,rigid,17589,21893,21919,4304,26,4330,completed
7474,rigid,17589,21893,21926,4304,33,4337,completed
7475,rigid,17589,21894,21927,4305,33,4338,completed
7476,rigid,17589,21894,21930,4305,36,4341,completed
7477,rigid,17589,21894,21941,4305,47,4352,completed
7478,rigid,17589,21894,21923,4305,29,4334,completed
7479,rigid,17589,21894,21916,4305,22,4327,completed
7480,rigid,17589,21894,21917,4305,23,4328,completed
7481,rigid,17589,21894,21919,4305,25,4330,completed
7482,rigid,17589,21894,21920,4305,26,4331,completed
7483,rigid,17589,21894,21915,4305,21,4326,completed
7484,rigid,17589,21895,21914,4306,19,4325,completed
7485,rigid,17589,21895,21917,4306,22,4328,completed
7486,rigid,17589,21895,21915,4306,20,4326,completed
7487,rigid,17589,21895,21924,4306,29,4335,completed
7488,rigid,17589,21895,21926,4306,31,4337,completed
7489,rigid,17589,21895,21917,4306,22,4328,completed
7490,rigid,17589,21895,21917,4306,22,4328,completed
7491,rigid,17589,21895,21920,4306,25,4331,completed
7492,rigid,17589,21896,21914,4307,18,4325,completed
7493,rigid,17589,21896,21933,4307,37,4344,completed
7494,rigid,17589,21896,21922,4307,26,4333,completed
7495,rigid,17589,21896,21924,4307,28,4335,completed
7496,rigid,17589,21897,21919,4308,22,4330,completed
7497,rigid,17589,21897,21929,4308,32,4340,completed
7498,rigid,17589,21897,21918,4308,21,4329,completed
7499,rigid,17589,21897,21925,4308,28,4336,completed
7500,rigid,17589,21898,21925,4309,27,4336,completed
7501,rigid,17589,21898,21917,4309,19,4328,completed
7502,rigid,17589,21898,21918,4309,20,4329,completed
7503,rigid,17589,21898,21928,4309,30,4339,completed
7504,rigid,17589,21898,21933,4309,35,4344,completed
7505,rigid,17589,21898,21924,4309,26,4335,completed
7506,rigid,17589,21898,21912,4309,14,4323,completed
7507,rigid,17589,21898,21918,4309,20,4329,completed
7508,rigid,17589,21898,21919,4309,21,4330,completed
7509,rigid,17589,21899,21932,4310,33,4343,completed
7510,rigid,17589,21899,21920,4310,21,4331,completed
7511,rigid,17589,21899,21925,4310,26,4336,completed
7512,rigid,17589,21899,21909,4310,10,4320,completed
7513,rigid,17589,21899,21921,4310,22,4332,completed
7514,rigid,17589,21899,21929,4310,30,4340,completed
7515,rigid,17589,21899,21921,4310,22,4332,completed
7516,rigid,17589,21899,21926,4310,27,4337,completed
7517,rigid,17589,21899,21925,4310,26,4336,completed
7518,rigid,17589,21899,21922,4310,23,4333,completed
7519,rigid,17589,21900,21925,4311,25,4336,completed
7520,rigid,17589,21900,21916,4311,16,4327,completed
7521,rigid,17589,21900,21925,4311,25,4336,completed
7522,rigid,17589,21900,21920,4311,20,4331,completed
7523,rigid,17589,21900,21927,4311,27,4338,completed
7524,rigid,17589,21900,21921,4311,21,4332,completed
7525,rigid,17589,21900,21928,4311,28,4339,completed
7526,rigid,17589,21901,21922,4312,21,4333,completed
7527,rigid,17589,21901,21928,4312,27,4339,completed
7528,rigid,17589,21901,21915,4312,14,4326,completed
7529,rigid,17589,21902,21922,4313,20,4333,completed
7530,rigid,17589,21902,21939,4313,37,4350,completed
7531,rigid,17589,21902,21925,4313,23,4336,completed
7532,rigid,17589,21902,21928,4313,26,4339,completed
7533,rigid,17589,21902,21929,4313,27,4340,completed
7534,rigid,17589,21902,21925,4313,23,4336,completed
7535,rigid,17589,21903,21930,4314,27,4341,completed
7536,rigid,17589,21903,21919,4314,16,4330,completed
7537,rigid,17589,21903,21927,4314,24,4338,completed
7538,rigid,17589,21904,21925,4315,21,4336,completed
7539,rigid,17589,21904,21939,4315,35,4350,completed
7540,rigid,17589,21904,21929,4315,25,4340,completed
7541,rigid,17616,21905,21913,4289,8,4297,completed
7542,rigid,17647,21906,21914,4259,8,4267,completed
7543,rigid,17685,21906,21934,4221,28,4249,completed
7544,rigid,17685,21907,21929,4222,22,4244,completed
7545,rigid,17685,21907,21938,4222,31,4253,completed
7546,rigid,17685,21907,21932,4222,25,4247,completed
7547,rigid,17685,21907,21929,4222,22,4244,completed
7548,rigid,17685,21908,21932,4223,24,4247,completed
7549,rigid,17685,21908,21934,4223,26,4249,completed
7550,rigid,17685,21908,21927,4223,19,4242,completed
7551,rigid,17685,21908,21946,4223,38,4261,completed
7552,rigid,17685,21908,21924,4223,16,4239,completed
7553,rigid,17685,21908,21955,4223,47,4270,completed
7554,rigid,17685,21908,21941,4223,33,4256,completed
7555,rigid,17685,21908,21938,4223,30,4253,completed
7556,rigid,17685,21908,21939,4223,31,4254,completed
7557,rigid,17685,21908,21926,4223,18,4241,completed
7558,rigid,17685,21909,21937,4224,28,4252,completed
7559,rigid,17685,21909,21934,4224,25,4249,completed
7560,rigid,17685,21909,21932,4224,23,4247,completed
7561,rigid,17685,21909,21929,4224,20,4244,completed
7562,rigid,17685,21909,21937,4224,28,4252,completed
7563,rigid,17685,21909,21938,4224,29,4253,completed
7564,rigid,17685,21909,21939,4224,30,4254,completed
7565,rigid,17685,21909,21940,4224,31,4255,completed
7566,rigid,17685,21910,21946,4225,36,4261,completed
7567,rigid,17685,21910,21940,4225,30,4255,completed
7568,rigid,17685,21910,21942,4225,32,4257,completed
7569,rigid,17685,21910,21930,4225,20,4245,completed
7570,rigid,17685,21910,21935,4225,25,4250,completed
7571,rigid,17685,21910,21942,4225,32,4257,completed
7572,rigid,17685,21911,21937,4226,26,4252,completed
7573,rigid,17685,21911,21931,4226,20,4246,completed
7574,rigid,17685,21911,21938,4226,27,4253,completed
7575,rigid,17685,21911,21932,4226,21,4247,completed
7576,rigid,17685,21911,21944,4226,33,4259,completed
7577,rigid,17685,21911,21943,4226,32,4258,completed
7578,rigid,17685,21911,21957,4226,46,4272,completed
7579,rigid,17685,21911,21932,4226,21,4247,completed
7580,rigid,17685,21911,21929,4226,18,4244,completed
7581,rigid,17685,21911,21931,4226,20,4246,completed
7582,rigid,17685,21911,21926,4226,15,4241,completed
7583,rigid,17685,21912,21945,4227,33,4260,completed
7584,rigid,17685,21912,21934,4227,22,4249,completed
7585,rigid,17685,21912,21944,4227,32,4259,completed
7586,rigid,17685,21913,21946,4228,33,4261,completed
7587,rigid,17685,21913,21943,4228,30,4258,completed
7588,rigid,17685,21913,21942,4228,29,4257,completed
7589,rigid,17685,21913,21952,4228,39,4267,completed
7590,rigid,17685,21913,21938,4228,25,4253,completed
7591,rigid,17685,21913,21930,4228,17,4245,completed
7592,rigid,17685,21913,21935,4228,22,4250,completed
7593,rigid,17685,21913,21934,4228,21,4249,completed
7594,rigid,17685,21913,21938,4228,25,4253,completed
7595,rigid,17685,21913,21933,4228,20,4248,completed
7596,rigid,17685,21913,21928,4228,15,4243,completed
7597,rigid,17685,21913,21933,4228,20,4248,completed
7598,rigid,17685,21913,21930,4228,17,4245,completed
7599,rigid,17685,21913,21937,4228,24,4252,completed
7600,rigid,17685,21913,21935,4228,22,4250,completed
7601,rigid,17685,21913,21936,4228,23,4251,completed
7602,rigid,17685,21913,21926,4228,13,4241,completed
7603,rigid,17685,21914,21934,4229,20,4249,completed
7604,rigid,17685,21914,21946,4229,32,4261,completed
7605,rigid,17685,21914,21942,4229,28,4257,completed
7606,rigid,17685,21914,21947,4229,33,4262,completed
7607,rigid,17685,21914,21935,4229,21,4250,completed
7608,rigid,17685,21914,21938,4229,24,4253,completed
7609,rigid,17685,21914,21940,4229,26,4255,completed
7610,rigid,17685,21914,21933,4229,19,4248,completed
7611,rigid,17685,21915,21939,4230,24,4254,completed
7612,rigid,17685,21915,21935,4230,20,4250,completed
7613,rigid,17685,21915,21945,4230,30,4260,completed
7614,rigid,17685,21915,21939,4230,24,4254,completed
7615,rigid,17685,21915,21943,4230,28,4258,completed
7616,rigid,17685,21915,21933,4230,18,4248,completed
7617,rigid,17685,21915,21947,4230,32,4262,completed
7618,rigid,17685,21915,21936,4230,21,4251,completed
7619,rigid,17685,21915,21933,4230,18,4248,completed
7620,rigid,17685,21916,21937,4231,21,4252,completed
7621,rigid,17685,21916,21941,4231,25,4256,completed
7622,rigid,17685,21916,21935,4231,19,4250,completed
7623,rigid,17685,21916,21952,4231,36,4267,completed
7624,rigid,17685,21916,21932,4231,16,4247,completed
7625,rigid,17685,21916,21949,4231,33,4264,completed
7626,rigid,17685,21917,21959,4232,42,4274,completed
7627,rigid,17685,21917,21941,4232,24,4256,completed
7628,rigid,17685,21917,21939,4232,22,4254,completed
7629,rigid,17685,21917,21925,4232,8,4240,completed
7630,rigid,17685,21917,21935,4232,18,4250,completed
7631,rigid,17685,21917,21937,4232,20,4252,completed
7632,rigid,17685,21917,21953,4232,36,4268,completed
7633,rigid,17685,21917,21946,4232,29,4261,completed
7634,rigid,17685,21917,21941,4232,24,4256,completed
7635,rigid,17685,21917,21945,4232,28,4260,completed
7636,rigid,17685,21917,21942,4232,25,4257,completed
7637,rigid,17685,21917,21950,4232,33,4265,completed
7638,rigid,17685,21917,21952,4232,35,4267,completed
7639,rigid,17685,21918,21946,4233,28,4261,completed
7640,rigid,17685,21918,21954,4233,36,4269,completed
7641,rigid,17685,21918,21947,4233,29,4262,completed
7642,rigid,17685,21918,21939,4233,21,4254,completed
7643,rigid,17685,21918,21940,4233,22,4255,completed
7644,rigid,17685,21918,21943,4233,25,4258,completed
7645,rigid,17685,21918,21949,4233,31,4264,completed
7646,rigid,17685,21918,21940,4233,22,4255,completed
7647,rigid,17685,21919,21938,4234,19,4253,completed
7648,rigid,17685,21919,21946,4234,27,4261,completed
7649,rigid,17685,21919,21946,4234,27,4261,completed
7650,rigid,17685,21919,21952,4234,33,4267,completed
7651,rigid,17685,21919,21966,4234,47,4281,completed
7652,rigid,17685,21919,21943,4234,24,4258,completed
7653,rigid,17685,21919,21935,4234,16,4250,completed
7654,rigid,17685,21919,21942,4234,23,4257,completed
7655,rigid,17685,21919,21941,4234,22,4256,completed
7656,rigid,17685,21920,21939,4235,19,4254,completed
7657,rigid,17685,21920,21944,4235,24,4259,completed
7658,rigid,17685,21920,21943,4235,23,4258,completed
7659,rigid,17685,21920,21945,4235,25,4260,completed
7660,rigid,17685,21920,21945,4235,25,4260,completed
7661,rigid,17685,21920,21957,4235,37,4272,completed
7662,rigid,17685,21920,21945,4235,25,4260,completed
7663,rigid,17685,21921,21939,4236,18,4254,completed
7664,rigid,17685,21921,21944,4236,23,4259,completed
7665,rigid,17685,21921,21945,4236,24,4260,completed
7666,rigid,17685,21922,21953,4237,31,4268,completed
7667,rigid,17685,21922,21948,4237,26,4263,completed
7668,rigid,17685,21922,21934,4237,12,4249,completed
7669,rigid,17685,21922,21947,4237,25,4262,completed
7670,rigid,17685,21922,21939,4237,17,4254,completed
7671,rigid,17685,21922,21942,4237,20,4257,completed
7672,rigid,17685,21922,21945,4237,23,4260,completed
7673,rigid,17685,21922,21947,4237,25,4262,completed
7674,rigid,17685,21922,21934,4237,12,4249,completed
7675,rigid,17685,21922,21945,4237,23,4260,completed
7676,rigid,17685,21922,21951,4237,29,4266,completed
7677,rigid,17685,21922,21948,4237,26,4263,completed
7678,rigid,17685,21922,21943,4237,21,4258,completed
7679,rigid,17685,21922,21949,4237,27,4264,completed
7680,rigid,17685,21923,21946,4238,23,4261,completed
7681,rigid,17685,21923,21950,4238,27,4265,completed
7682,rigid,17685,21923,21941,4238,18,4256,completed
7683,rigid,17685,21924,21941,4239,17,4256,completed
7684,rigid,17685,21924,21947,4239,23,4262,completed
7685,rigid,17685,21924,21951,4239,27,4266,completed
7686,rigid,17685,21924,21949,4239,25,4264,completed
7687,rigid,17785,21925,21926,4140,1,4141,completed
7688,rigid,17785,21925,21926,4140,1,4141,completed
7689,rigid,17785,21925,21930,4140,5,4145,completed
7690,rigid,17786,21926,21938,4140,12,4152,completed
7691,rigid,17786,21926,21938,4140,12,4152,completed
7692,rigid,17786,21926,21938,4140,12,4152,completed
7693,rigid,17919,21926,21955,4007,29,4036,completed
7694,rigid,17919,21926,21945,4007,19,4026,completed
7695,rigid,17919,21926,21953,4007,27,4034,completed
7696,rigid,17919,21926,21949,4007,23,4030,completed
7697,rigid,17919,21926,21946,4007,20,4027,completed
7698,rigid,17919,21927,21953,4008,26,4034,completed
7699,rigid,17919,21927,21964,4008,37,4045,completed
7700,rigid,17919,21927,21947,4008,20,4028,completed
7701,rigid,17919,21927,21955,4008,28,4036,completed
7702,rigid,17919,21928,21944,4009,16,4025,completed
7703,rigid,17919,21928,21970,4009,42,4051,completed
7704,rigid,17919,21928,21957,4009,29,4038,completed
7705,rigid,17919,21928,21954,4009,26,4035,completed
7706,rigid,17919,21928,21953,4009,25,4034,completed
7707,rigid,17919,21928,21950,4009,22,4031,completed
7708,rigid,17919,21928,21951,4009,23,4032,completed
7709,rigid,17919,21928,21958,4009,30,4039,completed
7710,rigid,17919,21929,21952,4010,23,4033,completed
7711,rigid,17919,21929,21953,4010,24,4034,completed
7712,rigid,17919,21929,21957,4010,28,4038,completed
7713,rigid,17919,21929,21954,4010,25,4035,completed
7714,rigid,17919,21929,21955,4010,26,4036,completed
7715,rigid,17919,21929,21957,4010,28,4038,completed
7716,rigid,17919,21929,21955,4010,26,4036,completed
7717,rigid,17919,21929,21960,4010,31,4041,completed
7718,rigid,17919,21929,21956,4010,27,4037,completed
7719,rigid,17919,21929,21951,4010,22,4032,completed
7720,rigid,17919,21929,21951,4010,22,4032,completed
7721,rigid,17919,21929,21955,4010,26,4036,completed
7722,rigid,17919,21929,21953,4010,24,4034,completed
7723,rigid,17919,21930,21948,4011,18,4029,completed
7724,rigid,17919,21930,21948,4011,18,4029,completed
7725,rigid,17919,21930,21953,4011,23,4034,completed
7726,rigid,17919,21930,21955,4011,25,4036,completed
7727,rigid,17919,21930,21968,4011,38,4049,completed
7728,rigid,17919,21930,21965,4011,35,4046,completed
7729,rigid,17919,21930,21950,4011,20,4031,completed
7730,rigid,17919,21930,21946,4011,16,4027,completed
7731,rigid,17919,21930,21948,4011,18,4029,completed
7732,rigid,17919,21930,21943,4011,13,4024,completed
7733,rigid,17919,21930,21954,4011,24,4035,completed
7734,rigid,17919,21930,21948,4011,18,4029,completed
7735,rigid,17919,21930,21952,4011,22,4033,completed
7736,rigid,17919,21930,21952,4011,22,4033,completed
7737,rigid,17919,21930,21952,4011,22,4033,completed
7738,rigid,17919,21930,21955,4011,25,4036,completed
7739,rigid,17919,21931,21961,4012,30,4042,completed
7740,rigid,17919,21931,21953,4012,22,4034,completed
7741,rigid,17919,21932,21949,4013,17,4030,completed
7742,rigid,17919,21932,21951,4013,19,4032,completed
7743,rigid,17919,21932,21952,4013,20,4033,completed
7744,rigid,17919,21932,21956,4013,24,4037,completed
7745,rigid,17919,21932,21953,4013,21,4034,completed
7746,rigid,17919,21932,21943,4013,11,4024,completed
7747,rigid,17919,21932,21953,4013,21,4034,completed
7748,rigid,17919,21932,21950,4013,18,4031,completed
7749,rigid,17919,21932,21940,4013,8,4021,completed
7750,rigid,17919,21932,21952,4013,20,4033,completed
7751,rigid,17919,21932,21950,4013,18,4031,completed
7752,rigid,17919,21932,21952,4013,20,4033,completed
7753,rigid,17919,21932,21951,4013,19,4032,completed
7754,rigid,17919,21932,21955,4013,23,4036,completed
7755,rigid,17919,21933,21954,4014,21,4035,completed
7756,rigid,17919,21933,21955,4014,22,4036,completed
7757,rigid,17919,21933,21958,4014,25,4039,completed
7758,rigid,17919,21933,21954,4014,21,4035,completed
7759,rigid,17919,21933,21955,4014,22,4036,completed
7760,rigid,17919,21933,21946,4014,13,4027,completed
7761,rigid,17919,21933,21949,4014,16,4030,completed
7762,rigid,17919,21933,21954,4014,21,4035,completed
7763,rigid,17919,21933,21957,4014,24,4038,completed
7764,rigid,17919,21933,21956,4014,23,4037,completed
7765,rigid,17919,21933,21957,4014,24,4038,completed
7766,rigid,17919,21934,21953,4015,19,4034,completed
7767,rigid,17919,21934,21963,4015,29,4044,completed
7768,rigid,17919,21934,21952,4015,18,4033,completed
7769,rigid,17919,21934,21951,4015,17,4032,completed
7770,rigid,17919,21934,21957,4015,23,4038,completed
7771,rigid,17919,21934,21957,4015,23,4038,completed
7772,rigid,17919,21934,21951,4015,17,4032,completed
7773,rigid,17919,21934,21957,4015,23,4038,completed
7774,rigid,17919,21934,21948,4015,14,4029,completed
7775,rigid,17919,21934,21962,4015,28,4043,completed
7776,rigid,17919,21934,21960,4015,26,4041,completed
7777,rigid,17919,21935,21960,4016,25,4041,completed
7778,rigid,17919,21935,21956,4016,21,4037,completed
7779,rigid,17919,21935,21951,4016,16,4032,completed
7780,rigid,17919,21935,21955,4016,20,4036,completed
7781,rigid,17919,21935,21959,4016,24,4040,completed
7782,rigid,17919,21935,21956,4016,21,4037,completed
7783,rigid,17919,21935,21953,4016,18,4034,completed
7784,rigid,17919,21935,21960,4016,25,4041,completed
7785,rigid,17919,21936,21959,4017,23,4040,completed
7786,rigid,17919,21936,21955,4017,19,4036,completed
7787,rigid,17919,21936,21957,4017,21,4038,completed
7788,rigid,17919,21936,21959,4017,23,4040,completed
7789,rigid,17919,21936,21963,4017,27,4044,completed
7790,rigid,17919,21936,21962,4017,26,4043,completed
7791,rigid,17919,21937,21956,4018,19,4037,completed
7792,rigid,17919,21937,21961,4018,24,4042,completed
7793,rigid,17919,21937,21960,4018,23,4041,completed
7794,rigid,17919,21937,21956,4018,19,4037,completed
7795,rigid,17919,21937,21955,4018,18,4036,completed
7796,rigid,17919,21937,21955,4018,18,4036,completed
7797,rigid,17919,21937,21960,4018,23,4041,completed
7798,rigid,17919,21937,21959,4018,22,4040,completed
7799,rigid,17919,21937,21964,4018,27,4045,completed
7800,rigid,17919,21938,21966,4019,28,4047,completed
7801,rigid,17919,21938,21947,4019,9,4028,completed
7802,rigid,17919,21938,21959,4019,21,4040,completed
7803,rigid,17919,21938,21954,4019,16,4035,completed
7804,rigid,17919,21938,21956,4019,18,4037,completed
7805,rigid,17919,21938,21949,4019,11,4030,completed
7806,rigid,17919,21938,21964,4019,26,4045,completed
7807,rigid,17919,21938,21955,4019,17,4036,completed
7808,rigid,17919,21938,21957,4019,19,4038,completed
7809,rigid,17919,21938,21957,4019,19,4038,completed
7810,rigid,17919,21938,21957,4019,19,4038,completed
7811,rigid,17919,21938,21960,4019,22,4041,completed
7812,rigid,17919,21938,21963,4019,25,4044,completed
7813,rigid,17919,21938,21958,4019,20,4039,completed
7814,rigid,17919,21938,21955,4019,17,4036,completed
7815,rigid,17919,21938,21957,4019,19,4038,completed
7816,rigid,17919,21938,21957,4019,19,4038,completed
7817,rigid,17919,21938,21961,4019,23,4042,completed
7818,rigid,17919,21938,21955,4019,17,4036,completed
7819,rigid,17919,21938,21951,4019,13,4032,completed
7820,rigid,17919,21938,21956,4019,18,4037,completed
7821,rigid,17919,21938,21954,4019,16,4035,completed
7822,rigid,17919,21938,21961,4019,23,4042,completed
7823,rigid,17919,21938,21959,4019,21,4040,completed
7824,rigid,17919,21939,21956,4020,17,4037,completed
7825,rigid,17919,21939,21955,4020,16,4036,completed
7826,rigid,17919,21939,21961,4020,22,4042,completed
7827,rigid,17919,21939,21959,4020,20,4040,completed
7828,rigid,17919,21939,21957,4020,18,4038,completed
7829,rigid,17919,21939,21958,4020,19,4039,completed
7830,rigid,17919,21939,21959,4020,20,4040,completed
7831,rigid,17919,21939,21962,4020,23,4043,completed
7832,rigid,17919,21939,21953,4020,14,4034,completed
7833,rigid,17919,21939,21955,4020,16,4036,completed
7834,rigid,17919,21939,21956,4020,17,4037,completed
7835,rigid,17919,21939,21965,4020,26,4046,completed
7836,rigid,17919,21939,21962,4020,23,4043,completed
7837,rigid,17928,21940,21991,4012,51,4063,completed
7838,rigid,17928,21946,23058,4018,1112,5130,completed
7839,rigid,17931,21946,21978,4015,32,4047,completed
7840,rigid,17934,21946,22634,4012,688,4700,completed
7841,rigid,17934,21947,22396,4013,449,4462,completed
7842,rigid,17934,21947,22581,4013,634,4647,completed
7843,rigid,17936,21947,25547,4011,3600,7611,completed
7844,rigid,17942,21947,22080,4005,133,4138,completed
7845,rigid,17942,21947,22079,4005,132,4137,completed
7846,rigid,17942,21948,22079,4006,131,4137,completed
7847,rigid,17942,21948,22090,4006,142,4148,completed
7848,rigid,17942,21949,22090,4007,141,4148,completed
7849,rigid,17942,21949,22088,4007,139,4146,completed
7850,rigid,17942,21950,22088,4008,138,4146,completed
7851,rigid,17942,21950,22086,4008,136,4144,completed
7852,rigid,17942,21951,22087,4009,136,4145,completed
7853,rigid,17942,21951,22086,4009,135,4144,completed
7854,rigid,17942,21951,22086,4009,135,4144,completed
7855,rigid,17942,21951,22085,4009,134,4143,completed
7856,rigid,17944,21951,27711,4007,5760,9767,completed
7857,rigid,17946,21952,22079,4006,127,4133,completed
7858,rigid,17946,21952,22078,4006,126,4132,completed
7859,rigid,17946,21952,22079,4006,127,4133,completed
7860,rigid,17946,21953,22083,4007,130,4137,completed
7861,rigid,17946,21953,22083,4007,130,4137,completed
7862,rigid,17946,21953,22083,4007,130,4137,completed
7863,rigid,17946,21953,22083,4007,130,4137,completed
7864,rigid,17946,21953,22082,4007,129,4136,completed
7865,rigid,17946,21954,22083,4008,129,4137,completed
7866,rigid,17946,21954,22082,4008,128,4136,completed
7867,rigid,17946,21954,22082,4008,128,4136,completed
7868,rigid,17946,21955,22083,4009,128,4137,completed
7869,rigid,17949,21955,22077,4006,122,4128,completed
7870,rigid,17949,21955,22076,4006,121,4127,completed
7871,rigid,17949,21955,21957,4006,2,4008,completed
7872,rigid,17949,21955,22081,4006,126,4132,completed
7873,rigid,17949,21955,22081,4006,126,4132,completed
7874,rigid,17949,21955,22081,4006,126,4132,completed
7875,rigid,17949,21955,22080,4006,125,4131,completed
7876,rigid,17949,21956,22080,4007,124,4131,completed
7877,rigid,17949,21956,22079,4007,123,4130,completed
7878,rigid,17949,21956,22078,4007,122,4129,completed
7879,rigid,17949,21956,22078,4007,122,4129,completed
7880,rigid,17949,21956,22078,4007,122,4129,completed
7881,rigid,17950,21957,23685,4007,1728,5735,completed
7882,rigid,17950,21957,23685,4007,1728,5735,completed
7883,rigid,17950,21957,23242,4007,1285,5292,completed
7884,rigid,17950,21957,22821,4007,864,4871,completed
7885,rigid,17950,21957,22821,4007,864,4871,completed
7886,rigid,17950,21958,22822,4008,864,4872,completed
7887,rigid,17951,21958,23686,4007,1728,5735,completed
7888,rigid,17951,21959,23687,4008,1728,5736,completed
7889,rigid,17951,21959,23687,4008,1728,5736,completed
7890,rigid,17952,21959,23687,4007,1728,5735,completed
7891,rigid,17952,21959,22818,4007,859,4866,completed
7892,rigid,17952,21959,23687,4007,1728,5735,completed
7893,rigid,17953,21959,23687,4006,1728,5734,completed
7894,rigid,17953,21959,23687,4006,1728,5734,completed
7895,rigid,17953,21960,23688,4007,1728,5735,completed
7896,rigid,17953,21960,23688,4007,1728,5735,completed
7897,rigid,17953,21961,23689,4008,1728,5736,completed
7898,rigid,17953,21962,23690,4009,1728,5737,completed
7899,rigid,17954,21962,22394,4008,432,4440,completed
7900,rigid,17954,21963,23691,4009,1728,5737,completed
7901,rigid,17954,21964,23692,4010,1728,5738,completed
7902,rigid,17954,21964,23692,4010,1728,5738,completed
7903,rigid,17955,21965,22797,4010,832,4842,completed
7904,rigid,17955,21966,22984,4011,1018,5029,completed
7905,rigid,17955,21966,22993,4011,1027,5038,completed
7906,rigid,17956,21967,22793,4011,826,4837,completed
7907,rigid,17956,21968,22588,4012,620,4632,completed
7908,rigid,17956,21969,22770,4013,801,4814,completed
7909,rigid,17958,21969,22401,4011,432,4443,completed
7910,rigid,17966,21970,21978,4004,8,4012,completed
7911,rigid,17966,21971,21995,4005,24,4029,completed
7912,rigid,17966,21971,21986,4005,15,4020,completed
7913,rigid,17966,21971,21999,4005,28,4033,completed
7914,rigid,17966,21972,21986,4006,14,4020,completed
7915,rigid,17966,21972,21985,4006,13,4019,completed
7916,rigid,17966,21972,21990,4006,18,4024,completed
7917,rigid,17966,21972,21991,4006,19,4025,completed
7918,rigid,17966,21974,21993,4008,19,4027,completed
7919,rigid,17966,21974,21987,4008,13,4021,completed
7920,rigid,17966,21974,22008,4008,34,4042,completed
7921,rigid,17966,21975,21992,4009,17,4026,completed
7922,rigid,17966,21975,21994,4009,19,4028,completed
7923,rigid,17966,21975,21991,4009,16,4025,completed
7924,rigid,17966,21975,21990,4009,15,4024,completed
7925,rigid,17966,21977,21994,4011,17,4028,completed
7926,rigid,17966,21977,22003,4011,26,4037,completed
7927,rigid,17966,21977,21993,4011,16,4027,completed
7928,rigid,17966,21977,21997,4011,20,4031,completed
7929,rigid,17966,21978,21997,4012,19,4031,completed
7930,rigid,17966,21978,21996,4012,18,4030,completed
7931,rigid,17966,21978,22001,4012,23,4035,completed
7932,rigid,17966,21978,21999,4012,21,4033,completed
7933,rigid,17966,21978,22003,4012,25,4037,completed
7934,rigid,17966,21980,22016,4014,36,4050,completed
7935,rigid,17966,21980,22009,4014,29,4043,completed
7936,rigid,17966,21980,21998,4014,18,4032,completed
7937,rigid,17966,21980,22001,4014,21,4035,completed
7938,rigid,17966,21983,22009,4017,26,4043,completed
7939,rigid,17966,21983,22003,4017,20,4037,completed
7940,rigid,17966,21983,21998,4017,15,4032,completed
7941,rigid,17966,21985,21993,4019,8,4027,completed
7942,rigid,17966,21985,21992,4019,7,4026,completed
7943,rigid,17966,21985,21994,4019,9,4028,completed
7944,rigid,17966,21985,21993,4019,8,4027,completed
7945,rigid,17966,21985,21991,4019,6,4025,completed
7946,rigid,17966,21986,22005,4020,19,4039,completed
7947,rigid,17966,21986,22010,4020,24,4044,completed
7948,rigid,17966,21986,22002,4020,16,4036,completed
7949,rigid,17966,21986,22008,4020,22,4042,completed
7950,rigid,17966,21986,22005,4020,19,4039,completed
7951,rigid,17966,21987,22003,4021,16,4037,completed
7952,rigid,17966,21987,22004,4021,17,4038,completed
7953,rigid,17966,21987,22004,4021,17,4038,completed
7954,rigid,17966,21987,22003,4021,16,4037,completed
7955,rigid,17966,21987,22002,4021,15,4036,completed
7956,rigid,17966,21988,22006,4022,18,4040,completed
7957,rigid,17966,21988,22003,4022,15,4037,completed
7958,rigid,17966,21988,22002,4022,14,4036,completed
7959,rigid,17966,21988,22004,4022,16,4038,completed
7960,rigid,17966,21990,22007,4024,17,4041,completed
7961,rigid,17966,21990,22007,4024,17,4041,completed
7962,rigid,17966,21991,22005,4025,14,4039,completed
7963,rigid,17966,21991,22006,4025,15,4040,completed
7964,rigid,17966,21991,22007,4025,16,4041,completed
7965,rigid,17966,21991,22008,4025,17,4042,completed
7966,rigid,17966,21991,22006,4025,15,4040,completed
7967,rigid,17966,21991,22007,4025,16,4041,completed
7968,rigid,17966,21991,22005,4025,14,4039,completed
7969,rigid,17966,21992,22007,4026,15,4041,completed
7970,rigid,17966,21992,22005,4026,13,4039,completed
7971,rigid,17966,21992,22009,4026,17,4043,completed
7972,rigid,17966,21992,22007,4026,15,4041,completed
7973,rigid,17966,21992,22010,4026,18,4044,completed
7974,rigid,17966,21993,22009,4027,16,4043,completed
7975,rigid,17966,21993,22009,4027,16,4043,completed
7976,rigid,17966,21993,22009,4027,16,4043,completed
7977,rigid,17966,21993,22009,4027,16,4043,completed
7978,rigid,17966,21993,22010,4027,17,4044,completed
7979,rigid,17966,21993,22004,4027,11,4038,completed
7980,rigid,17966,21993,22006,4027,13,4040,completed
7981,rigid,17966,21993,22008,4027,15,4042,completed
7982,rigid,17966,21994,22010,4028,16,4044,completed
7983,rigid,17966,21994,22010,4028,16,4044,completed
7984,rigid,17966,21994,22012,4028,18,4046,completed
7985,rigid,17966,21994,22006,4028,12,4040,completed
7986,rigid,17966,21994,22012,4028,18,4046,completed
7987,rigid,17966,21994,22006,4028,12,4040,completed
7988,rigid,17966,21995,22006,4029,11,4040,completed
7989,rigid,17966,21995,22010,4029,15,4044,completed
7990,rigid,17966,21995,22010,4029,15,4044,completed
7991,rigid,17966,21995,22011,4029,16,4045,completed
7992,rigid,17966,21995,22012,4029,17,4046,completed
7993,rigid,17966,21995,22011,4029,16,4045,completed
7994,rigid,17966,21995,22009,4029,14,4043,completed
7995,rigid,17966,21995,22004,4029,9,4038,completed
7996,rigid,17966,21995,22010,4029,15,4044,completed
7997,rigid,17966,21996,22008,4030,12,4042,completed
7998,rigid,17966,21997,22009,4031,12,4043,completed
7999,rigid,17966,21997,22011,4031,14,4045,completed
8000,rigid,17966,21997,22013,4031,16,4047,completed
8001,rigid,17966,21997,22011,4031,14,4045,completed
8002,rigid,17966,21997,22011,4031,14,4045,completed
8003,rigid,17966,21997,22011,4031,14,4045,completed
8004,rigid,17966,21998,22015,4032,17,4049,completed
8005,rigid,17966,21998,22014,4032,16,4048,completed
8006,rigid,17966,21999,22017,4033,18,4051,completed
8007,rigid,17966,21999,22017,4033,18,4051,completed
8008,rigid,17966,22001,22025,4035,24,4059,completed
8009,rigid,17966,22001,22014,4035,13,4048,completed
8010,rigid,17966,22001,22014,4035,13,4048,completed
8011,rigid,17966,22001,22016,4035,15,4050,completed
8012,rigid,17966,22001,22012,4035,11,4046,completed
8013,rigid,17966,22002,22015,4036,13,4049,completed
8014,rigid,17966,22002,22014,4036,12,4048,completed
8015,rigid,17966,22002,22019,4036,17,4053,completed
8016,rigid,17966,22003,22019,4037,16,4053,completed
8017,rigid,17966,22003,22021,4037,18,4055,completed
8018,rigid,17966,22003,22019,4037,16,4053,completed
8019,rigid,17966,22003,22018,4037,15,4052,completed
8020,rigid,17966,22003,22010,4037,7,4044,completed
8021,rigid,17966,22003,22011,4037,8,4045,completed
8022,rigid,17966,22003,22010,4037,7,4044,completed
8023,rigid,17966,22003,22010,4037,7,4044,completed
8024,rigid,17966,22003,22018,4037,15,4052,completed
8025,rigid,17966,22003,22017,4037,14,4051,completed
8026,rigid,17966,22004,22015,4038,11,4049,completed
8027,rigid,17966,22004,22026,4038,22,4060,completed
8028,rigid,17966,22004,22019,4038,15,4053,completed
8029,rigid,17966,22004,22014,4038,10,4048,completed
8030,rigid,17966,22004,22018,4038,14,4052,completed
8031,rigid,17966,22005,22019,4039,14,4053,completed
8032,rigid,17966,22005,22019,4039,14,4053,completed
8033,rigid,17966,22005,22016,4039,11,4050,completed
8034,rigid,17966,22005,22023,4039,18,4057,completed
8035,rigid,17966,22005,22023,4039,18,4057,completed
8036,rigid,17966,22006,22021,4040,15,4055,completed
8037,rigid,17966,22006,22019,4040,13,4053,completed
8038,rigid,17966,22006,22019,4040,13,4053,completed
8039,rigid,17966,22006,22020,4040,14,4054,completed
8040,rigid,17966,22006,22016,4040,10,4050,completed
8041,rigid,17966,22006,22027,4040,21,4061,completed
8042,rigid,17966,22006,22020,4040,14,4054,completed
8043,rigid,17966,22006,22024,4040,18,4058,completed
8044,rigid,17966,22006,22019,4040,13,4053,completed
8045,rigid,17966,22006,22015,4040,9,4049,completed
8046,rigid,17966,22007,22021,4041,14,4055,completed
8047,rigid,17966,22007,22019,4041,12,4053,completed
8048,rigid,17966,22007,22026,4041,19,4060,completed
8049,rigid,17966,22007,22028,4041,21,4062,completed
8050,rigid,17966,22007,22019,4041,12,4053,completed
8051,rigid,17966,22007,22022,4041,15,4056,completed
8052,rigid,17966,22007,22024,4041,17,4058,completed
8053,rigid,17966,22007,22020,4041,13,4054,completed
8054,rigid,17967,22008,22037,4041,29,4070,completed
8055,rigid,17967,22010,22518,4043,508,4551,completed
8056,rigid,17981,22010,25466,4029,3456,7485,completed
8057,rigid,17981,22010,25466,4029,3456,7485,completed
8058,rigid,17981,22010,25466,4029,3456,7485,completed
8059,rigid,17981,22010,25466,4029,3456,7485,completed
8060,rigid,17981,22010,25466,4029,3456,7485,completed
8061,rigid,17981,22010,25466,4029,3456,7485,completed
8062,rigid,17981,22010,25466,4029,3456,7485,completed
8063,rigid,17981,22010,22012,4029,2,4031,completed
8064,rigid,17981,22010,22012,4029,2,4031,completed
8065,rigid,17981,22010,22013,4029,3,4032,completed
8066,rigid,17981,22010,22013,4029,3,4032,completed
8067,rigid,17981,22010,22012,4029,2,4031,completed
8068,rigid,17981,22010,25466,4029,3456,7485,completed
8069,rigid,17981,22010,25466,4029,3456,7485,completed
8070,rigid,17981,22010,25466,4029,3456,7485,completed
8071,rigid,17981,22010,25466,4029,3456,7485,completed
8072,rigid,17981,22010,25466,4029,3456,7485,completed
8073,rigid,17981,22010,25466,4029,3456,7485,completed
8074,rigid,17981,22010,25466,4029,3456,7485,completed
8075,rigid,17981,22010,25466,4029,3456,7485,completed
8076,rigid,17981,22010,25466,4029,3456,7485,completed
8077,rigid,17981,22010,25466,4029,3456,7485,completed
8078,rigid,17981,22010,25466,4029,3456,7485,completed
8079,rigid,17981,22010,25466,4029,3456,7485,completed
8080,rigid,17981,22010,25466,4029,3456,7485,completed
8081,rigid,17981,22010,25466,4029,3456,7485,completed
8082,rigid,17981,22010,25466,4029,3456,7485,completed
8083,rigid,17981,22010,25466,4029,3456,7485,completed
8084,rigid,17981,22010,25466,4029,3456,7485,completed
8085,rigid,17981,22010,25466,4029,3456,7485,completed
8086,rigid,17981,22010,25466,4029,3456,7485,completed
8087,rigid,17981,22010,25466,4029,3456,7485,completed
8088,rigid,17981,22010,25466,4029,3456,7485,completed
8089,rigid,17981,22010,25466,4029,3456,7485,completed
8090,rigid,17981,22010,25466,4029,3456,7485,completed
8091,rigid,17981,22010,25466,4029,3456,7485,completed
8092,rigid,17981,22010,25466,4029,3456,7485,completed
8093,rigid,17981,22010,25466,4029,3456,7485,completed
8094,rigid,17981,22010,25466,4029,3456,7485,completed
8095,rigid,17981,22010,25466,4029,3456,7485,completed
8096,rigid,17981,22010,25466,4029,3456,7485,completed
8097,rigid,17981,22010,25466,4029,3456,7485,completed
8098,rigid,17981,22010,25466,4029,3456,7485,completed
8099,rigid,17981,22010,25466,4029,3456,7485,completed
8100,rigid,17981,22010,25466,4029,3456,7485,completed
8101,rigid,17981,22010,25466,4029,3456,7485,completed
8102,rigid,17981,22010,25466,4029,3456,7485,completed
8103,rigid,17981,22010,25466,4029,3456,7485,completed
8104,rigid,17981,22010,25466,4029,3456,7485,completed
8105,rigid,17981,22010,25466,4029,3456,7485,completed
8106,rigid,17981,22010,25466,4029,3456,7485,completed
8107,rigid,17981,22010,25466,4029,3456,7485,completed
8108,rigid,17981,22010,25466,4029,3456,7485,completed
8109,rigid,17981,22010,25466,4029,3456,7485,completed
8110,rigid,17981,22010,25466,4029,3456,7485,completed
8111,rigid,17981,22010,25466,4029,3456,7485,completed
8112,rigid,17981,22010,22216,4029,206,4235,completed
8113,rigid,17981,22010,25466,4029,3456,7485,completed
8114,rigid,17981,22010,23793,4029,1783,5812,completed
8115,rigid,17981,22010,23022,4029,1012,5041,completed
8116,rigid,17981,22010,23870,4029,1860,5889,completed
8117,rigid,17981,22010,25466,4029,3456,7485,completed
8118,rigid,17981,22010,25466,4029,3456,7485,completed
8119,rigid,17981,22010,25466,4029,3456,7485,completed
8120,rigid,17981,22010,25466,4029,3456,7485,completed
8121,rigid,17981,22010,25466,4029,3456,7485,completed
8122,rigid,17981,22010,25466,4029,3456,7485,completed
8123,rigid,17981,22010,25466,4029,3456,7485,completed
8124,rigid,17981,22010,25466,4029,3456,7485,completed
8125,rigid,17981,22010,25466,4029,3456,7485,completed
8126,rigid,17982,22012,22030,4030,18,4048,completed
8127,rigid,17982,22016,22021,4034,5,4039,completed
8128,rigid,17982,22019,22039,4037,20,4057,completed
8129,rigid,17985,22021,22539,4036,518,4554,completed
8130,rigid,17990,22039,23540,4049,1501,5550,completed
8131,rigid,17990,22052,23539,4062,1487,5549,completed
8132,rigid,17990,22077,22573,4087,496,4583,completed
8133,rigid,17991,22078,22547,4087,469,4556,completed
8134,rigid,17992,22079,22151,4087,72,4159,completed
8135,rigid,18004,22079,25679,4075,3600,7675,completed
8136,rigid,18005,22079,22088,4074,9,4083,completed
8137,rigid,18005,22079,22086,4074,7,4081,completed
8138,rigid,18005,22079,22088,4074,9,4083,completed
8139,rigid,18005,22079,22095,4074,16,4090,completed
8140,rigid,18005,22079,22089,4074,10,4084,completed
8141,rigid,18005,22079,22093,4074,14,4088,completed
8142,rigid,18005,22080,22092,4075,12,4087,completed
8143,rigid,18005,22080,22090,4075,10,4085,completed
8144,rigid,18005,22080,22092,4075,12,4087,completed
8145,rigid,18005,22080,22093,4075,13,4088,completed
8146,rigid,18005,22080,22094,4075,14,4089,completed
8147,rigid,18005,22080,22095,4075,15,4090,completed
8148,rigid,18005,22080,22098,4075,18,4093,completed
8149,rigid,18005,22080,22093,4075,13,4088,completed
8150,rigid,18005,22080,22093,4075,13,4088,completed
8151,rigid,18005,22080,22092,4075,12,4087,completed
8152,rigid,18005,22080,22094,4075,14,4089,completed
8153,rigid,18005,22081,22093,4076,12,4088,completed
8154,rigid,18005,22081,22100,4076,19,4095,completed
8155,rigid,18005,22081,22102,4076,21,4097,completed
8156,rigid,18005,22081,22093,4076,12,4088,completed
8157,rigid,18005,22081,22095,4076,14,4090,completed
8158,rigid,18005,22081,22095,4076,14,4090,completed
8159,rigid,18005,22081,22096,4076,15,4091,completed
8160,rigid,18005,22081,22096,4076,15,4091,completed
8161,rigid,18005,22081,22097,4076,16,4092,completed
8162,rigid,18005,22081,22094,4076,13,4089,completed
8163,rigid,18005,22081,22092,4076,11,4087,completed
8164,rigid,18005,22082,22096,4077,14,4091,completed
8165,rigid,18005,22082,22092,4077,10,4087,completed
8166,rigid,18005,22082,22090,4077,8,4085,completed
8167,rigid,18005,22082,22088,4077,6,4083,completed
8168,rigid,18005,22082,22091,4077,9,4086,completed
8169,rigid,18005,22082,22090,4077,8,4085,completed
8170,rigid,18005,22082,22091,4077,9,4086,completed
8171,rigid,18005,22082,22091,4077,9,4086,completed
8172,rigid,18005,22082,22091,4077,9,4086,completed
8173,rigid,18005,22082,22090,4077,8,4085,completed
8174,rigid,18005,22083,22093,4078,10,4088,completed
8175,rigid,18005,22083,22100,4078,17,4095,completed
8176,rigid,18005,22083,22100,4078,17,4095,completed
8177,rigid,18005,22083,22099,4078,16,4094,completed
8178,rigid,18005,22083,22107,4078,24,4102,completed
8179,rigid,18005,22083,22101,4078,18,4096,completed
8180,rigid,18005,22083,22094,4078,11,4089,completed
8181,rigid,18005,22083,22094,4078,11,4089,completed
8182,rigid,18005,22083,22095,4078,12,4090,completed
8183,rigid,18005,22083,22094,4078,11,4089,completed
8184,rigid,18005,22083,22097,4078,14,4092,completed
8185,rigid,18005,22083,22095,4078,12,4090,completed
8186,rigid,18005,22083,22099,4078,16,4094,completed
8187,rigid,18005,22083,22094,4078,11,4089,completed
8188,rigid,18005,22083,22097,4078,14,4092,completed
8189,rigid,18005,22083,22106,4078,23,4101,completed
8190,rigid,18005,22083,22098,4078,15,4093,completed
8191,rigid,18005,22083,22093,4078,10,4088,completed
8192,rigid,18005,22083,22096,4078,13,4091,completed
8193,rigid,18005,22083,22097,4078,14,4092,completed
8194,rigid,18005,22083,22097,4078,14,4092,completed
8195,rigid,18005,22083,22094,4078,11,4089,completed
8196,rigid,18005,22085,22100,4080,15,4095,completed
8197,rigid,18005,22085,22097,4080,12,4092,completed
8198,rigid,18005,22085,22099,4080,14,4094,completed
8199,rigid,18005,22085,22098,4080,13,4093,completed
8200,rigid,18005,22085,22100,4080,15,4095,completed
8201,rigid,18005,22085,22100,4080,15,4095,completed
8202,rigid,18005,22085,22099,4080,14,4094,completed
8203,rigid,18005,22085,22101,4080,16,4096,completed
8204,rigid,18005,22085,22095,4080,10,4090,completed
8205,rigid,18005,22085,22091,4080,6,4086,completed
8206,rigid,18005,22085,22094,4080,9,4089,completed
8207,rigid,18005,22086,22102,4081,16,4097,completed
8208,rigid,18005,22086,22099,4081,13,4094,completed
8209,rigid,18005,22086,22096,4081,10,4091,completed
8210,rigid,18005,22086,22109,4081,23,4104,completed
8211,rigid,18005,22086,22097,4081,11,4092,completed
8212,rigid,18005,22086,22107,4081,21,4102,completed
8213,rigid,18005,22086,22099,4081,13,4094,completed
8214,rigid,18005,22086,22098,4081,12,4093,completed
8215,rigid,18005,22086,22097,4081,11,4092,completed
8216,rigid,18005,22086,22096,4081,10,4091,completed
8217,rigid,18005,22086,22104,4081,18,4099,completed
8218,rigid,18005,22086,22102,4081,16,4097,completed
8219,rigid,18005,22087,22103,4082,16,4098,completed
8220,rigid,18005,22087,22103,4082,16,4098,completed
8221,rigid,18005,22087,22099,4082,12,4094,completed
8222,rigid,18005,22087,22096,4082,9,4091,completed
8223,rigid,18005,22088,22096,4083,8,4091,completed
8224,rigid,18005,22088,22097,4083,9,4092,completed
8225,rigid,18005,22088,22097,4083,9,4092,completed
8226,rigid,18005,22088,22096,4083,8,4091,completed
8227,rigid,18005,22088,22097,4083,9,4092,completed
8228,rigid,18005,22088,22097,4083,9,4092,completed
8229,rigid,18005,22088,22095,4083,7,4090,completed
8230,rigid,18005,22088,22097,4083,9,4092,completed
8231,rigid,18005,22088,22098,4083,10,4093,completed
8232,rigid,18005,22088,22101,4083,13,4096,completed
8233,rigid,18005,22089,22101,4084,12,4096,completed
8234,rigid,18005,22089,22103,4084,14,4098,completed
8235,rigid,18005,22089,22104,4084,15,4099,completed
8236,rigid,18005,22089,22102,4084,13,4097,completed
8237,rigid,18005,22090,22101,4085,11,4096,completed
8238,rigid,18005,22090,22104,4085,14,4099,completed
8239,rigid,18005,22090,22103,4085,13,4098,completed
8240,rigid,18005,22090,22104,4085,14,4099,completed
8241,rigid,18005,22090,22104,4085,14,4099,completed
8242,rigid,18005,22090,22100,4085,10,4095,completed
8243,rigid,18005,22090,22101,4085,11,4096,completed
8244,rigid,18005,22090,22100,4085,10,4095,completed
8245,rigid,18005,22090,22103,4085,13,4098,completed
8246,rigid,18005,22090,22102,4085,12,4097,completed
8247,rigid,18005,22090,22096,4085,6,4091,completed
8248,rigid,18005,22090,22099,4085,9,4094,completed
8249,rigid,18005,22090,22098,4085,8,4093,completed
8250,rigid,18005,22090,22099,4085,9,4094,completed
8251,rigid,18005,22090,22097,4085,7,4092,completed
8252,rigid,18005,22090,22098,4085,8,4093,completed
8253,rigid,18005,22090,22098,4085,8,4093,completed
8254,rigid,18005,22090,22097,4085,7,4092,completed
8255,rigid,18005,22090,22097,4085,7,4092,completed
8256,rigid,18005,22091,22099,4086,8,4094,completed
8257,rigid,18005,22091,22098,4086,7,4093,completed
8258,rigid,18005,22091,22100,4086,9,4095,completed
8259,rigid,18005,22091,22098,4086,7,4093,completed
8260,rigid,18005,22091,22102,4086,11,4097,completed
8261,rigid,18005,22092,22105,4087,13,4100,completed
8262,rigid,18005,22092,22103,4087,11,4098,completed
8263,rigid,18005,22092,22102,4087,10,4097,completed
8264,rigid,18005,22092,22106,4087,14,4101,completed
8265,rigid,18005,22092,22109,4087,17,4104,completed
8266,rigid,18005,22093,22111,4088,18,4106,completed
8267,rigid,18005,22093,22103,4088,10,4098,completed
8268,rigid,18005,22093,22104,4088,11,4099,completed
8269,rigid,18005,22093,22104,4088,11,4099,completed
8270,rigid,18005,22093,22105,4088,12,4100,completed
8271,rigid,18005,22093,22103,4088,10,4098,completed
8272,rigid,18005,22093,22106,4088,13,4101,completed
8273,rigid,18005,22093,22103,4088,10,4098,completed
8274,rigid,18005,22093,22105,4088,12,4100,completed
8275,rigid,18005,22093,22100,4088,7,4095,completed
8276,rigid,18005,22093,22101,4088,8,4096,completed
8277,rigid,18005,22093,22102,4088,9,4097,completed
8278,rigid,18005,22094,22104,4089,10,4099,completed
8279,rigid,18005,22094,22104,4089,10,4099,completed
8280,rigid,18024,22094,22106,4070,12,4082,completed
8281,rigid,18029,22099,22963,4070,864,4934,completed
8282,rigid,18031,22099,22107,4068,8,4076,completed
8283,rigid,18031,22099,22107,4068,8,4076,completed
8284,rigid,18031,22099,22108,4068,9,4077,completed
8285,rigid,18031,22099,22105,4068,6,4074,completed
8286,rigid,18031,22099,22114,4068,15,4083,completed
8287,rigid,18031,22100,22113,4069,13,4082,completed
8288,rigid,18031,22100,22111,4069,11,4080,completed
8289,rigid,18031,22100,22110,4069,10,4079,completed
8290,rigid,18031,22100,22111,4069,11,4080,completed
8291,rigid,18031,22100,22109,4069,9,4078,completed
8292,rigid,18031,22100,22109,4069,9,4078,completed
8293,rigid,18031,22100,22108,4069,8,4077,completed
8294,rigid,18031,22100,22108,4069,8,4077,completed
8295,rigid,18031,22100,22109,4069,9,4078,completed
8296,rigid,18031,22100,22109,4069,9,4078,completed
8297,rigid,18031,22101,22108,4070,7,4077,completed
8298,rigid,18031,22101,22109,4070,8,4078,completed
8299,rigid,18031,22101,22111,4070,10,4080,completed
8300,rigid,18031,22101,22113,4070,12,4082,completed
8301,rigid,18031,22101,22118,4070,17,4087,completed
8302,rigid,18031,22101,22112,4070,11,4081,completed
8303,rigid,18031,22101,22112,4070,11,4081,completed
8304,rigid,18031,22102,22113,4071,11,4082,completed
8305,rigid,18031,22102,22116,4071,14,4085,completed
8306,rigid,18031,22102,22113,4071,11,4082,completed
8307,rigid,18031,22102,22109,4071,7,4078,completed
8308,rigid,18031,22102,22109,4071,7,4078,completed
8309,rigid,18031,22102,22111,4071,9,4080,completed
8310,rigid,18031,22102,22108,4071,6,4077,completed
8311,rigid,18031,22102,22111,4071,9,4080,completed
8312,rigid,18031,22103,22111,4072,8,4080,completed
8313,rigid,18031,22103,22112,4072,9,4081,completed
8314,rigid,18031,22103,22121,4072,18,4090,completed
8315,rigid,18031,22103,22116,4072,13,4085,completed
8316,rigid,18031,22103,22113,4072,10,4082,completed
8317,rigid,18031,22103,22122,4072,19,4091,completed
8318,rigid,18031,22103,22115,4072,12,4084,completed
8319,rigid,18031,22103,22117,4072,14,4086,completed
8320,rigid,18031,22103,22115,4072,12,4084,completed
8321,rigid,18031,22103,22119,4072,16,4088,completed
8322,rigid,18031,22103,22113,4072,10,4082,completed
8323,rigid,18031,22103,22113,4072,10,4082,completed
8324,rigid,18031,22103,22113,4072,10,4082,completed
8325,rigid,18031,22103,22117,4072,14,4086,completed
8326,rigid,18031,22103,22110,4072,7,4079,completed
8327,rigid,18031,22103,22112,4072,9,4081,completed
8328,rigid,18031,22103,22110,4072,7,4079,completed
8329,rigid,18031,22103,22111,4072,8,4080,completed
8330,rigid,18031,22103,22110,4072,7,4079,completed
8331,rigid,18031,22103,22110,4072,7,4079,completed
8332,rigid,18031,22103,22111,4072,8,4080,completed
8333,rigid,18031,22103,22112,4072,9,4081,completed
8334,rigid,18031,22103,22111,4072,8,4080,completed
8335,rigid,18031,22103,22109,4072,6,4078,completed
8336,rigid,18031,22103,22112,4072,9,4081,completed
8337,rigid,18031,22104,22115,4073,11,4084,completed
8338,rigid,18031,22104,22114,4073,10,4083,completed
8339,rigid,18031,22104,22117,4073,13,4086,completed
8340,rigid,18031,22104,22116,4073,12,4085,completed
8341,rigid,18031,22104,22114,4073,10,4083,completed
8342,rigid,18031,22104,22114,4073,10,4083,completed
8343,rigid,18031,22104,22114,4073,10,4083,completed
8344,rigid,18031,22104,22116,4073,12,4085,completed
8345,rigid,18031,22104,22111,4073,7,4080,completed
8346,rigid,18031,22105,22110,4074,5,4079,completed
8347,rigid,18031,22105,22111,4074,6,4080,completed
8348,rigid,18031,22105,22114,4074,9,4083,completed
8349,rigid,18031,22105,22114,4074,9,4083,completed
8350,rigid,18031,22106,22114,4075,8,4083,completed
8351,rigid,18031,22106,22112,4075,6,4081,completed
8352,rigid,18031,22106,22112,4075,6,4081,completed
8353,rigid,18031,22106,22114,4075,8,4083,completed
8354,rigid,18031,22106,22114,4075,8,4083,completed
8355,rigid,18031,22106,22115,4075,9,4084,completed
8356,rigid,18031,22106,22112,4075,6,4081,completed
8357,rigid,18031,22107,22116,4076,9,4085,completed
8358,rigid,18031,22107,22111,4076,4,4080,completed
8359,rigid,18031,22107,22117,4076,10,4086,completed
8360,rigid,18031,22107,22117,4076,10,4086,completed
8361,rigid,18031,22108,22119,4077,11,4088,completed
8362,rigid,18031,22108,22122,4077,14,4091,completed
8363,rigid,18031,22108,22121,4077,13,4090,completed
8364,rigid,18031,22108,22118,4077,10,4087,completed
8365,rigid,18031,22108,22116,4077,8,4085,completed
8366,rigid,18031,22109,22116,4078,7,4085,completed
8367,rigid,18031,22109,22119,4078,10,4088,completed
8368,rigid,18031,22109,22120,4078,11,4089,completed
8369,rigid,18031,22109,22120,4078,11,4089,completed
8370,rigid,18031,22109,22118,4078,9,4087,completed
8371,rigid,18031,22109,22118,4078,9,4087,completed
8372,rigid,18031,22109,22116,4078,7,4085,completed
8373,rigid,18031,22109,22117,4078,8,4086,completed
8374,rigid,18031,22109,22115,4078,6,4084,completed
8375,rigid,18031,22109,22118,4078,9,4087,completed
8376,rigid,18031,22110,22116,4079,6,4085,completed
8377,rigid,18031,22110,22118,4079,8,4087,completed
8378,rigid,18031,22110,22117,4079,7,4086,completed
8379,rigid,18031,22110,22119,4079,9,4088,completed
8380,rigid,18031,22110,22118,4079,8,4087,completed
8381,rigid,18031,22110,22120,4079,10,4089,completed
8382,rigid,18031,22111,22121,4080,10,4090,completed
8383,rigid,18031,22111,22121,4080,10,4090,completed
8384,rigid,18031,22111,22121,4080,10,4090,completed
8385,rigid,18031,22111,22124,4080,13,4093,completed
8386,rigid,18031,22111,22121,4080,10,4090,completed
8387,rigid,18031,22111,22121,4080,10,4090,completed
8388,rigid,18031,22111,22124,4080,13,4093,completed
8389,rigid,18031,22111,22123,4080,12,4092,completed
8390,rigid,18031,22111,22121,4080,10,4090,completed
8391,rigid,18031,22111,22118,4080,7,4087,completed
8392,rigid,18031,22111,22120,4080,9,4089,completed
8393,rigid,18031,22111,22117,4080,6,4086,completed
8394,rigid,18031,22111,22118,4080,7,4087,completed
8395,rigid,18031,22112,22120,4081,8,4089,completed
8396,rigid,18031,22112,22119,4081,7,4088,completed
8397,rigid,18031,22112,22121,4081,9,4090,completed
8398,rigid,18031,22112,22119,4081,7,4088,completed
8399,rigid,18031,22112,22120,4081,8,4089,completed
8400,rigid,18031,22112,22121,4081,9,4090,completed
8401,rigid,18031,22112,22119,4081,7,4088,completed
8402,rigid,18031,22112,22118,4081,6,4087,completed
8403,rigid,18031,22112,22120,4081,8,4089,completed
8404,rigid,18031,22112,22118,4081,6,4087,completed
8405,rigid,18031,22112,22118,4081,6,4087,completed
8406,rigid,18031,22112,22119,4081,7,4088,completed
8407,rigid,18031,22112,22120,4081,8,4089,completed
8408,rigid,18031,22112,22118,4081,6,4087,completed
8409,rigid,18031,22112,22121,4081,9,4090,completed
8410,rigid,18031,22112,22119,4081,7,4088,completed
8411,rigid,18031,22112,22120,4081,8,4089,completed
8412,rigid,18031,22113,22121,4082,8,4090,completed
8413,rigid,18031,22113,22121,4082,8,4090,completed
8414,rigid,18031,22113,22122,4082,9,4091,completed
8415,rigid,18031,22113,22118,4082,5,4087,completed
8416,rigid,18031,22113,22119,4082,6,4088,completed
8417,rigid,18031,22113,22119,4082,6,4088,completed
8418,rigid,18031,22113,22120,4082,7,4089,completed
8419,rigid,18031,22113,22123,4082,10,4092,completed
8420,rigid,18031,22114,22127,4083,13,4096,completed
8421,rigid,18031,22114,22129,4083,15,4098,completed
8422,rigid,18031,22114,22125,4083,11,4094,completed
8423,rigid,18031,22114,22130,4083,16,4099,completed
8424,rigid,18031,22114,22124,4083,10,4093,completed
8425,rigid,18031,22114,22129,4083,15,4098,completed
8426,rigid,18031,22116,22134,4085,18,4103,completed
8427,rigid,18034,22134,22136,4100,2,4102,completed
8428,rigid,18034,22134,22164,4100,30,4130,completed
8429,rigid,18048,22134,25734,4086,3600,7686,completed
8430,rigid,18050,22134,22140,4084,6,4090,completed
8431,rigid,18050,22134,22140,4084,6,4090,completed
8432,rigid,18050,22134,22141,4084,7,4091,completed
8433,rigid,18050,22134,22142,4084,8,4092,completed
8434,rigid,18050,22134,22142,4084,8,4092,completed
8435,rigid,18050,22134,22140,4084,6,4090,completed
8436,rigid,18050,22134,22143,4084,9,4093,completed
8437,rigid,18050,22134,22139,4084,5,4089,completed
8438,rigid,18050,22134,22142,4084,8,4092,completed
8439,rigid,18050,22134,22140,4084,6,4090,completed
8440,rigid,18050,22134,22140,4084,6,4090,completed
8441,rigid,18050,22134,22151,4084,17,4101,completed
8442,rigid,18050,22134,22146,4084,12,4096,completed
8443,rigid,18050,22134,22146,4084,12,4096,completed
8444,rigid,18050,22134,22145,4084,11,4095,completed
8445,rigid,18050,22135,22145,4085,10,4095,completed
8446,rigid,18050,22135,22143,4085,8,4093,completed
8447,rigid,18050,22135,22143,4085,8,4093,completed
8448,rigid,18050,22135,22142,4085,7,4092,completed
8449,rigid,18050,22135,22143,4085,8,4093,completed
8450,rigid,18050,22135,22141,4085,6,4091,completed
8451,rigid,18050,22135,22143,4085,8,4093,completed
8452,rigid,18050,22135,22144,4085,9,4094,completed
8453,rigid,18050,22135,22144,4085,9,4094,completed
8454,rigid,18050,22135,22144,4085,9,4094,completed
8455,rigid,18050,22135,22142,4085,7,4092,completed
8456,rigid,18050,22135,22144,4085,9,4094,completed
8457,rigid,18050,22135,22144,4085,9,4094,completed
8458,rigid,18050,22135,22140,4085,5,4090,completed
8459,rigid,18050,22135,22143,4085,8,4093,completed
8460,rigid,18050,22135,22141,4085,6,4091,completed
8461,rigid,18050,22135,22142,4085,7,4092,completed
8462,rigid,18050,22135,22142,4085,7,4092,completed
8463,rigid,18050,22135,22143,4085,8,4093,completed
8464,rigid,18050,22135,22143,4085,8,4093,completed
8465,rigid,18050,22135,22142,4085,7,4092,completed
8466,rigid,18050,22135,22141,4085,6,4091,completed
8467,rigid,18050,22135,22143,4085,8,4093,completed
8468,rigid,18050,22135,22140,4085,5,4090,completed
8469,rigid,18050,22135,22142,4085,7,4092,completed
8470,rigid,18050,22135,22143,4085,8,4093,completed
8471,rigid,18050,22135,22143,4085,8,4093,completed
8472,rigid,18050,22135,22143,4085,8,4093,completed
8473,rigid,18050,22135,22143,4085,8,4093,completed
8474,rigid,18050,22135,22143,4085,8,4093,completed
8475,rigid,18050,22135,22142,4085,7,4092,completed
8476,rigid,18050,22135,22141,4085,6,4091,completed
8477,rigid,18050,22135,22141,4085,6,4091,completed
8478,rigid,18050,22135,22143,4085,8,4093,completed
8479,rigid,18050,22135,22143,4085,8,4093,completed
8480,rigid,18050,22135,22141,4085,6,4091,completed
8481,rigid,18050,22135,22144,4085,9,4094,completed
8482,rigid,18050,22135,22140,4085,5,4090,completed
8483,rigid,18050,22135,22143,4085,8,4093,completed
8484,rigid,18050,22135,22142,4085,7,4092,completed
8485,rigid,18050,22135,22143,4085,8,4093,completed
8486,rigid,18050,22135,22142,4085,7,4092,completed
8487,rigid,18050,22135,22143,4085,8,4093,completed
8488,rigid,18050,22135,22141,4085,6,4091,completed
8489,rigid,18050,22135,22143,4085,8,4093,completed
8490,rigid,18050,22135,22146,4085,11,4096,completed
8491,rigid,18050,22135,22147,4085,12,4097,completed
8492,rigid,18050,22135,22147,4085,12,4097,completed
8493,rigid,18050,22135,22145,4085,10,4095,completed
8494,rigid,18050,22135,22142,4085,7,4092,completed
8495,rigid,18050,22135,22143,4085,8,4093,completed
8496,rigid,18050,22135,22140,4085,5,4090,completed
8497,rigid,18050,22135,22141,4085,6,4091,completed
8498,rigid,18050,22135,22142,4085,7,4092,completed
8499,rigid,18050,22135,22143,4085,8,4093,completed
8500,rigid,18050,22135,22142,4085,7,4092,completed
8501,rigid,18050,22135,22147,4085,12,4097,completed
8502,rigid,18062,22135,22175,4073,40,4113,completed
8503,rigid,18071,22135,22136,4064,1,4065,completed
8504,rigid,18072,22136,23000,4064,864,4928,completed
8505,rigid,18072,22136,22148,4064,12,4076,completed
8506,rigid,18072,22136,22171,4064,35,4099,completed
8507,rigid,18072,22136,22164,4064,28,4092,completed
8508,rigid,18072,22136,22153,4064,17,4081,completed
8509,rigid,18072,22136,22155,4064,19,4083,completed
8510,rigid,18072,22136,22154,4064,18,4082,completed
8511,rigid,18072,22136,22145,4064,9,4073,completed
8512,rigid,18072,22136,22152,4064,16,4080,completed
8513,rigid,18072,22136,22151,4064,15,4079,completed
8514,rigid,18072,22136,22151,4064,15,4079,completed
8515,rigid,18072,22136,22150,4064,14,4078,completed
8516,rigid,18072,22136,22154,4064,18,4082,completed
8517,rigid,18072,22136,22161,4064,25,4089,completed
8518,rigid,18072,22136,22168,4064,32,4096,completed
8519,rigid,18072,22136,22168,4064,32,4096,completed
8520,rigid,18072,22136,22174,4064,38,4102,completed
8521,rigid,18072,22136,22159,4064,23,4087,completed
8522,rigid,18072,22136,22160,4064,24,4088,completed
8523,rigid,18072,22136,22168,4064,32,4096,completed
8524,rigid,18072,22136,22159,4064,23,4087,completed
8525,rigid,18072,22136,22147,4064,11,4075,completed
8526,rigid,18072,22136,22153,4064,17,4081,completed
8527,rigid,18072,22136,22165,4064,29,4093,completed
8528,rigid,18072,22136,22161,4064,25,4089,completed
8529,rigid,18072,22136,22161,4064,25,4089,completed
8530,rigid,18072,22136,22148,4064,12,4076,completed
8531,rigid,18072,22136,22155,4064,19,4083,completed
8532,rigid,18072,22136,22154,4064,18,4082,completed
8533,rigid,18072,22136,22156,4064,20,4084,completed
8534,rigid,18072,22136,22156,4064,20,4084,completed
8535,rigid,18072,22136,22156,4064,20,4084,completed
8536,rigid,18072,22136,22170,4064,34,4098,completed
8537,rigid,18072,22136,22166,4064,30,4094,completed
8538,rigid,18072,22136,22161,4064,25,4089,completed
8539,rigid,18072,22136,22144,4064,8,4072,completed
8540,rigid,18072,22136,22141,4064,5,4069,completed
8541,rigid,18072,22136,22159,4064,23,4087,completed
8542,rigid,18072,22136,22163,4064,27,4091,completed
8543,rigid,18072,22136,22169,4064,33,4097,completed
8544,rigid,18072,22136,22167,4064,31,4095,completed
8545,rigid,18072,22136,22161,4064,25,4089,completed
8546,rigid,18072,22136,22155,4064,19,4083,completed
8547,rigid,18072,22136,22151,4064,15,4079,completed
8548,rigid,18072,22136,22150,4064,14,4078,completed
8549,rigid,18072,22136,22158,4064,22,4086,completed
8550,rigid,18072,22136,22153,4064,17,4081,completed
8551,rigid,18072,22136,22154,4064,18,4082,completed
8552,rigid,18072,22136,22149,4064,13,4077,completed
8553,rigid,18072,22136,22155,4064,19,4083,completed
8554,rigid,18072,22136,22150,4064,14,4078,completed
8555,rigid,18072,22136,22151,4064,15,4079,completed
8556,rigid,18072,22136,22149,4064,13,4077,completed
8557,rigid,18072,22136,22151,4064,15,4079,completed
8558,rigid,18072,22136,22152,4064,16,4080,completed
8559,rigid,18072,22136,22146,4064,10,4074,completed
8560,rigid,18072,22136,22148,4064,12,4076,completed
8561,rigid,18072,22136,22152,4064,16,4080,completed
8562,rigid,18072,22136,22153,4064,17,4081,completed
8563,rigid,18072,22136,22148,4064,12,4076,completed
8564,rigid,18072,22136,22151,4064,15,4079,completed
8565,rigid,18072,22136,22149,4064,13,4077,completed
8566,rigid,18072,22136,22156,4064,20,4084,completed
8567,rigid,18072,22136,22157,4064,21,4085,completed
8568,rigid,18072,22136,22160,4064,24,4088,completed
8569,rigid,18072,22136,22153,4064,17,4081,completed
8570,rigid,18072,22136,22155,4064,19,4083,completed
8571,rigid,18072,22136,22159,4064,23,4087,completed
8572,rigid,18072,22136,22154,4064,18,4082,completed
8573,rigid,18072,22136,22151,4064,15,4079,completed
8574,rigid,18072,22136,22148,4064,12,4076,completed
8575,rigid,18072,22136,22150,4064,14,4078,completed
8576,rigid,18072,22139,22153,4067,14,4081,completed
8577,rigid,18072,22140,22160,4068,20,4088,completed
8578,rigid,18072,22140,22173,4068,33,4101,completed
8579,rigid,18072,22140,22163,4068,23,4091,completed
8580,rigid,18072,22140,22183,4068,43,4111,completed
8581,rigid,18072,22140,22179,4068,39,4107,completed
8582,rigid,18072,22140,22170,4068,30,4098,completed
8583,rigid,18072,22140,22163,4068,23,4091,completed
8584,rigid,18072,22140,22158,4068,18,4086,completed
8585,rigid,18072,22140,22156,4068,16,4084,completed
8586,rigid,18072,22141,22156,4069,15,4084,completed
8587,rigid,18072,22141,22157,4069,16,4085,completed
8588,rigid,18072,22141,22164,4069,23,4092,completed
8589,rigid,18072,22141,22178,4069,37,4106,completed
8590,rigid,18072,22141,22179,4069,38,4107,completed
8591,rigid,18072,22141,22191,4069,50,4119,completed
8592,rigid,18072,22141,22175,4069,34,4103,completed
8593,rigid,18072,22141,22178,4069,37,4106,completed
8594,rigid,18072,22141,22189,4069,48,4117,completed
8595,rigid,18072,22141,22181,4069,40,4109,completed
8596,rigid,18072,22142,22168,4070,26,4096,completed
8597,rigid,18072,22142,22174,4070,32,4102,completed
8598,rigid,18072,22142,22172,4070,30,4100,completed
8599,rigid,18072,22142,22186,4070,44,4114,completed
8600,rigid,18072,22142,22194,4070,52,4122,completed
8601,rigid,18072,22142,22202,4070,60,4130,completed
8602,rigid,18072,22142,22170,4070,28,4098,completed
8603,rigid,18072,22142,22174,4070,32,4102,completed
8604,rigid,18072,22142,22179,4070,37,4107,completed
8605,rigid,18072,22142,22183,4070,41,4111,completed
8606,rigid,18072,22142,22178,4070,36,4106,completed
8607,rigid,18072,22142,22175,4070,33,4103,completed
8608,rigid,18072,22142,22194,4070,52,4122,completed
8609,rigid,18072,22142,22181,4070,39,4109,completed
8610,rigid,18072,22142,22200,4070,58,4128,completed
8611,rigid,18072,22143,22166,4071,23,4094,completed
8612,rigid,18072,22143,22165,4071,22,4093,completed
8613,rigid,18072,22143,22172,4071,29,4100,completed
8614,rigid,18072,22143,22171,4071,28,4099,completed
8615,rigid,18072,22143,22194,4071,51,4122,completed
8616,rigid,18072,22143,22196,4071,53,4124,completed
8617,rigid,18072,22143,22171,4071,28,4099,completed
8618,rigid,18072,22143,22183,4071,40,4111,completed
8619,rigid,18072,22143,22188,4071,45,4116,completed
8620,rigid,18072,22143,22171,4071,28,4099,completed
8621,rigid,18072,22143,22175,4071,32,4103,completed
8622,rigid,18072,22143,22166,4071,23,4094,completed
8623,rigid,18072,22143,22183,4071,40,4111,completed
8624,rigid,18072,22143,22173,4071,30,4101,completed
8625,rigid,18072,22143,22171,4071,28,4099,completed
8626,rigid,18072,22143,22170,4071,27,4098,completed
8627,rigid,18072,22143,22174,4071,31,4102,completed
8628,rigid,18072,22143,22172,4071,29,4100,completed
8629,rigid,18072,22143,22167,4071,24,4095,completed
8630,rigid,18072,22143,22172,4071,29,4100,completed
8631,rigid,18072,22143,22175,4071,32,4103,completed
8632,rigid,18072,22143,22167,4071,24,4095,completed
8633,rigid,18072,22144,22159,4072,15,4087,completed
8634,rigid,18072,22144,22164,4072,20,4092,completed
8635,rigid,18072,22144,22178,4072,34,4106,completed
8636,rigid,18072,22144,22163,4072,19,4091,completed
8637,rigid,18072,22144,22197,4072,53,4125,completed
8638,rigid,18072,22144,22165,4072,21,4093,completed
8639,rigid,18072,22144,22170,4072,26,4098,completed
8640,rigid,18072,22145,22177,4073,32,4105,completed
8641,rigid,18072,22145,22181,4073,36,4109,completed
8642,rigid,18072,22145,22185,4073,40,4113,completed
8643,rigid,18072,22145,22178,4073,33,4106,completed
8644,rigid,18072,22146,22171,4074,25,4099,completed
8645,rigid,18072,22146,22166,4074,20,4094,completed
8646,rigid,18072,22146,22182,4074,36,4110,completed
8647,rigid,18072,22146,22166,4074,20,4094,completed
8648,rigid,18072,22146,22162,4074,16,4090,completed
8649,rigid,18072,22146,22165,4074,19,4093,completed
8650,rigid,18072,22146,22180,4074,34,4108,completed
8651,rigid,18072,22146,22172,4074,26,4100,completed
8652,rigid,18072,22147,22180,4075,33,4108,completed
8653,rigid,18072,22147,22186,4075,39,4114,completed
8654,rigid,18072,22147,22171,4075,24,4099,completed
8655,rigid,18072,22147,22173,4075,26,4101,completed
8656,rigid,18072,22148,22179,4076,31,4107,completed
8657,rigid,18072,22148,22179,4076,31,4107,completed
8658,rigid,18072,22148,22178,4076,30,4106,completed
8659,rigid,18072,22148,22179,4076,31,4107,completed
8660,rigid,18072,22148,22190,4076,42,4118,completed
8661,rigid,18072,22149,22212,4077,63,4140,completed
8662,rigid,18072,22149,22172,4077,23,4100,completed
8663,rigid,18072,22149,22180,4077,31,4108,completed
8664,rigid,18072,22150,22187,4078,37,4115,completed
8665,rigid,18072,22150,22209,4078,59,4137,completed
8666,rigid,18072,22150,22187,4078,37,4115,completed
8667,rigid,18072,22150,22198,4078,48,4126,completed
8668,rigid,18072,22150,22190,4078,40,4118,completed
8669,rigid,18072,22150,22188,4078,38,4116,completed
8670,rigid,18072,22150,22205,4078,55,4133,completed
8671,rigid,18072,22150,22222,4078,72,4150,completed
8672,rigid,18072,22150,22222,4078,72,4150,completed
8673,rigid,18072,22150,22210,4078,60,4138,completed
8674,rigid,18072,22150,22196,4078,46,4124,completed
8675,rigid,18072,22150,22197,4078,47,4125,completed
8676,rigid,18072,22150,22184,4078,34,4112,completed
8677,rigid,18072,22150,22196,4078,46,4124,completed
8678,rigid,18072,22150,22192,4078,42,4120,completed
8679,rigid,18072,22150,22182,4078,32,4110,completed
8680,rigid,18072,22151,22201,4079,50,4129,completed
8681,rigid,18072,22151,22185,4079,34,4113,completed
8682,rigid,18072,22151,22205,4079,54,4133,completed
8683,rigid,18072,22151,22172,4079,21,4100,completed
8684,rigid,18072,22151,22177,4079,26,4105,completed
8685,rigid,18072,22151,22188,4079,37,4116,completed
8686,rigid,18072,22151,22172,4079,21,4100,completed
8687,rigid,18072,22151,22223,4079,72,4151,completed
8688,rigid,18072,22151,22205,4079,54,4133,completed
8689,rigid,18072,22151,22181,4079,30,4109,completed
8690,rigid,18072,22151,22182,4079,31,4110,completed
8691,rigid,18072,22151,22195,4079,44,4123,completed
8692,rigid,18072,22151,22191,4079,40,4119,completed
8693,rigid,18072,22151,22196,4079,45,4124,completed
8694,rigid,18072,22151,22195,4079,44,4123,completed
8695,rigid,18072,22151,22196,4079,45,4124,completed
8696,rigid,18072,22152,22182,4080,30,4110,completed
8697,rigid,18072,22152,22176,4080,24,4104,completed
8698,rigid,18072,22152,22177,4080,25,4105,completed
8699,rigid,18072,22153,22181,4081,28,4109,completed
8700,rigid,18072,22153,22177,4081,24,4105,completed
8701,rigid,18072,22153,22178,4081,25,4106,completed
8702,rigid,18072,22153,22177,4081,24,4105,completed
8703,rigid,18072,22153,22181,4081,28,4109,completed
8704,rigid,18072,22153,22187,4081,34,4115,completed
8705,rigid,18072,22154,22182,4082,28,4110,completed
8706,rigid,18072,22154,22183,4082,29,4111,completed
8707,rigid,18072,22154,22175,4082,21,4103,completed
8708,rigid,18072,22154,22186,4082,32,4114,completed
8709,rigid,18072,22154,22189,4082,35,4117,completed
8710,rigid,18072,22155,22197,4083,42,4125,completed
8711,rigid,18072,22155,22205,4083,50,4133,completed
8712,rigid,18072,22155,22182,4083,27,4110,completed
8713,rigid,18072,22155,22192,4083,37,4120,completed
8714,rigid,18072,22155,22205,4083,50,4133,completed
8715,rigid,18072,22156,22189,4084,33,4117,completed
8716,rigid,18072,22156,22191,4084,35,4119,completed
8717,rigid,18072,22156,22193,4084,37,4121,completed
8718,rigid,18072,22156,22184,4084,28,4112,completed
8719,rigid,18072,22156,22180,4084,24,4108,completed
8720,rigid,18072,22156,22179,4084,23,4107,completed
8721,rigid,18072,22157,22169,4085,12,4097,completed
8722,rigid,18072,22157,22182,4085,25,4110,completed
8723,rigid,18072,22158,22180,4086,22,4108,completed
8724,rigid,18072,22158,22175,4086,17,4103,completed
8725,rigid,18072,22158,22193,4086,35,4121,completed
8726,rigid,18072,22158,22186,4086,28,4114,completed
8727,rigid,18072,22158,22185,4086,27,4113,completed
8728,rigid,18072,22158,22186,4086,28,4114,completed
8729,rigid,18072,22159,22187,4087,28,4115,completed
8730,rigid,18072,22159,22189,4087,30,4117,completed
8731,rigid,18072,22159,22189,4087,30,4117,completed
8732,rigid,18072,22159,22186,4087,27,4114,completed
8733,rigid,18072,22159,22214,4087,55,4142,completed
8734,rigid,18072,22160,22190,4088,30,4118,completed
8735,rigid,18072,22160,22186,4088,26,4114,completed
8736,rigid,18072,22160,22197,4088,37,4125,completed
8737,rigid,18072,22161,22220,4089,59,4148,completed
8738,rigid,18072,22161,22200,4089,39,4128,completed
8739,rigid,18072,22161,22190,4089,29,4118,completed
8740,rigid,18072,22161,22198,4089,37,4126,completed
8741,rigid,18072,22161,22196,4089,35,4124,completed
8742,rigid,18072,22162,22210,4090,48,4138,completed
8743,rigid,18072,22163,22235,4091,72,4163,completed
8744,rigid,18072,22163,22218,4091,55,4146,completed
8745,rigid,18072,22163,22209,4091,46,4137,completed
8746,rigid,18072,22163,22198,4091,35,4126,completed
8747,rigid,18072,22164,22205,4092,41,4133,completed
8748,rigid,18072,22164,22204,4092,40,4132,completed
8749,rigid,18072,22164,22205,4092,41,4133,completed
8750,rigid,18072,22164,22204,4092,40,4132,completed
8751,rigid,18072,22164,22202,4092,38,4130,completed
8752,rigid,18072,22164,22209,4092,45,4137,completed
8753,rigid,18072,22164,22197,4092,33,4125,completed
8754,rigid,18072,22165,22225,4093,60,4153,completed
8755,rigid,18072,22165,22193,4093,28,4121,completed
8756,rigid,18072,22165,22191,4093,26,4119,completed
8757,rigid,18072,22165,22187,4093,22,4115,completed
8758,rigid,18072,22165,22186,4093,21,4114,completed
8759,rigid,18072,22165,22207,4093,42,4135,completed
8760,rigid,18072,22165,22202,4093,37,4130,completed
8761,rigid,18072,22165,22203,4093,38,4131,completed
8762,rigid,18072,22165,22206,4093,41,4134,completed
8763,rigid,18072,22165,22213,4093,48,4141,completed
8764,rigid,18072,22165,22195,4093,30,4123,completed
8765,rigid,18072,22165,22211,4093,46,4139,completed
8766,rigid,18072,22165,22206,4093,41,4134,completed
8767,rigid,18072,22165,22183,4093,18,4111,completed
8768,rigid,18072,22165,22208,4093,43,4136,completed
8769,rigid,18072,22165,22200,4093,35,4128,completed
8770,rigid,18072,22166,22199,4094,33,4127,completed
8771,rigid,18072,22166,22198,4094,32,4126,completed
8772,rigid,18072,22166,22176,4094,10,4104,completed
8773,rigid,18072,22166,22182,4094,16,4110,completed
8774,rigid,18072,22166,22181,4094,15,4109,completed
8775,rigid,18072,22167,22197,4095,30,4125,completed
8776,rigid,18072,22167,22209,4095,42,4137,completed
8777,rigid,18072,22167,22189,4095,22,4117,completed
8778,rigid,18072,22168,22189,4096,21,4117,completed
8779,rigid,18072,22168,22196,4096,28,4124,completed
8780,rigid,18072,22168,22214,4096,46,4142,completed
8781,rigid,18072,22168,22189,4096,21,4117,completed
8782,rigid,18072,22169,22212,4097,43,4140,completed
8783,rigid,18072,22169,22215,4097,46,4143,completed
8784,rigid,18072,22170,22186,4098,16,4114,completed
8785,rigid,18072,22170,22210,4098,40,4138,completed
8786,rigid,18072,22170,22213,4098,43,4141,completed
8787,rigid,18072,22170,22215,4098,45,4143,completed
8788,rigid,18072,22170,22189,4098,19,4117,completed
8789,rigid,18072,22171,22189,4099,18,4117,completed
8790,rigid,18072,22171,22195,4099,24,4123,completed
8791,rigid,18072,22171,22203,4099,32,4131,completed
8792,rigid,18072,22171,22193,4099,22,4121,completed
8793,rigid,18075,22172,22173,4097,1,4098,completed
8794,rigid,18085,22172,22173,4087,1,4088,completed
8795,rigid,18088,22173,23073,4085,900,4985,completed
8796,rigid,18089,22173,22175,4084,2,4086,completed
8797,rigid,18100,22173,23621,4073,1448,5521,completed
8798,rigid,18102,22174,23255,4072,1081,5153,completed
8799,rigid,18102,22175,23135,4073,960,5033,completed
8800,rigid,18104,22175,23327,4071,1152,5223,completed
8801,rigid,18108,22175,22189,4067,14,4081,completed
8802,rigid,18108,22175,22199,4067,24,4091,completed
8803,rigid,18108,22175,22198,4067,23,4090,completed
8804,rigid,18108,22175,22204,4067,29,4096,completed
8805,rigid,18108,22175,22214,4067,39,4106,completed
8806,rigid,18108,22175,22204,4067,29,4096,completed
8807,rigid,18108,22175,22209,4067,34,4101,completed
8808,rigid,18108,22175,22205,4067,30,4097,completed
8809,rigid,18108,22175,22202,4067,27,4094,completed
8810,rigid,18108,22175,22201,4067,26,4093,completed
8811,rigid,18108,22175,22199,4067,24,4091,completed
8812,rigid,18108,22175,22208,4067,33,4100,completed
8813,rigid,18108,22175,22235,4067,60,4127,completed
8814,rigid,18108,22175,22198,4067,23,4090,completed
8815,rigid,18108,22175,22200,4067,25,4092,completed
8816,rigid,18108,22175,22216,4067,41,4108,completed
8817,rigid,18108,22176,22224,4068,48,4116,completed
8818,rigid,18108,22176,22215,4068,39,4107,completed
8819,rigid,18108,22177,22211,4069,34,4103,completed
8820,rigid,18108,22177,22213,4069,36,4105,completed
8821,rigid,18108,22177,22212,4069,35,4104,completed
8822,rigid,18108,22177,22217,4069,40,4109,completed
8823,rigid,18108,22177,22238,4069,61,4130,completed
8824,rigid,18108,22178,22235,4070,57,4127,completed
8825,rigid,18108,22178,22224,4070,46,4116,completed
8826,rigid,18108,22178,22211,4070,33,4103,completed
8827,rigid,18108,22178,22215,4070,37,4107,completed
8828,rigid,18108,22178,22218,4070,40,4110,completed
8829,rigid,18108,22178,22218,4070,40,4110,completed
8830,rigid,18108,22178,22219,4070,41,4111,completed
8831,rigid,18108,22178,22227,4070,49,4119,completed
8832,rigid,18108,22178,22222,4070,44,4114,completed
8833,rigid,18108,22178,22212,4070,34,4104,completed
8834,rigid,18108,22178,22233,4070,55,4125,completed
8835,rigid,18108,22178,22209,4070,31,4101,completed
8836,rigid,18108,22178,22200,4070,22,4092,completed
8837,rigid,18108,22178,22201,4070,23,4093,completed
8838,rigid,18108,22178,22197,4070,19,4089,completed
8839,rigid,18108,22179,22229,4071,50,4121,completed
8840,rigid,18108,22179,22217,4071,38,4109,completed
8841,rigid,18108,22179,22218,4071,39,4110,completed
8842,rigid,18108,22179,22217,4071,38,4109,completed
8843,rigid,18108,22179,22226,4071,47,4118,completed
8844,rigid,18108,22179,22207,4071,28,4099,completed
8845,rigid,18108,22179,22223,4071,44,4115,completed
8846,rigid,18108,22180,22224,4072,44,4116,completed
8847,rigid,18108,22180,22199,4072,19,4091,completed
8848,rigid,18108,22180,22232,4072,52,4124,completed
8849,rigid,18108,22180,22232,4072,52,4124,completed
8850,rigid,18108,22180,22220,4072,40,4112,completed
8851,rigid,18108,22181,22217,4073,36,4109,completed
8852,rigid,18108,22181,22199,4073,18,4091,completed
8853,rigid,18108,22181,22201,4073,20,4093,completed
8854,rigid,18108,22181,22197,4073,16,4089,completed
8855,rigid,18108,22181,22210,4073,29,4102,completed
8856,rigid,18108,22181,22233,4073,52,4125,completed
8857,rigid,18108,22181,22203,4073,22,4095,completed
8858,rigid,18108,22182,22212,4074,30,4104,completed
8859,rigid,18108,22182,22216,4074,34,4108,completed
8860,rigid,18108,22182,22217,4074,35,4109,completed
8861,rigid,18108,22182,22206,4074,24,4098,completed
8862,rigid,18108,22182,22223,4074,41,4115,completed
8863,rigid,18108,22182,22225,4074,43,4117,completed
8864,rigid,18108,22182,22198,4074,16,4090,completed
8865,rigid,18108,22182,22221,4074,39,4113,completed
8866,rigid,18108,22183,22225,4075,42,4117,completed
8867,rigid,18108,22183,22219,4075,36,4111,completed
8868,rigid,18108,22183,22205,4075,22,4097,completed
8869,rigid,18108,22183,22200,4075,17,4092,completed
8870,rigid,18108,22183,22218,4075,35,4110,completed
8871,rigid,18108,22183,22217,4075,34,4109,completed
8872,rigid,18108,22184,22206,4076,22,4098,completed
8873,rigid,18108,22184,22197,4076,13,4089,completed
8874,rigid,18108,22185,22206,4077,21,4098,completed
8875,rigid,18108,22185,22213,4077,28,4105,completed
8876,rigid,18108,22185,22208,4077,23,4100,completed
8877,rigid,18108,22186,22220,4078,34,4112,completed
8878,rigid,18108,22186,22209,4078,23,4101,completed
8879,rigid,18108,22186,22216,4078,30,4108,completed
8880,rigid,18108,22186,22214,4078,28,4106,completed
8881,rigid,18108,22186,22217,4078,31,4109,completed
8882,rigid,18108,22186,22219,4078,33,4111,completed
8883,rigid,18108,22186,22215,4078,29,4107,completed
8884,rigid,18108,22186,22212,4078,26,4104,completed
8885,rigid,18108,22186,22232,4078,46,4124,completed
8886,rigid,18108,22187,22216,4079,29,4108,completed
8887,rigid,18108,22187,22221,4079,34,4113,completed
8888,rigid,18108,22187,22229,4079,42,4121,completed
8889,rigid,18108,22187,22234,4079,47,4126,completed
8890,rigid,18108,22187,22231,4079,44,4123,completed
8891,rigid,18108,22188,22223,4080,35,4115,completed
8892,rigid,18108,22188,22209,4080,21,4101,completed
8893,rigid,18108,22188,22207,4080,19,4099,completed
8894,rigid,18108,22189,22209,4081,20,4101,completed
8895,rigid,18108,22189,22226,4081,37,4118,completed
8896,rigid,18108,22189,22232,4081,43,4124,completed
8897,rigid,18108,22189,22239,4081,50,4131,completed
8898,rigid,18108,22189,22212,4081,23,4104,completed
8899,rigid,18108,22189,22220,4081,31,4112,completed
8900,rigid,18108,22189,22221,4081,32,4113,completed
8901,rigid,18108,22189,22222,4081,33,4114,completed
8902,rigid,18108,22189,22223,4081,34,4115,completed
8903,rigid,18108,22189,22220,4081,31,4112,completed
8904,rigid,18108,22189,22221,4081,32,4113,completed
8905,rigid,18108,22190,22225,4082,35,4117,completed
8906,rigid,18108,22190,22226,4082,36,4118,completed
8907,rigid,18108,22190,22217,4082,27,4109,completed
8908,rigid,18108,22190,22212,4082,22,4104,completed
8909,rigid,18108,22191,22211,4083,20,4103,completed
8910,rigid,18108,22191,22210,4083,19,4102,completed
8911,rigid,18108,22191,22239,4083,48,4131,completed
8912,rigid,18108,22191,22229,4083,38,4121,completed
8913,rigid,18108,22192,22222,4084,30,4114,completed
8914,rigid,18108,22192,22219,4084,27,4111,completed
8915,rigid,18108,22193,22239,4085,46,4131,completed
8916,rigid,18108,22193,22219,4085,26,4111,completed
8917,rigid,18108,22193,22231,4085,38,4123,completed
8918,rigid,18108,22193,22237,4085,44,4129,completed
8919,rigid,18108,22194,22216,4086,22,4108,completed
8920,rigid,18108,22194,22239,4086,45,4131,completed
8921,rigid,18108,22194,22237,4086,43,4129,completed
8922,rigid,18108,22195,22231,4087,36,4123,completed
8923,rigid,18108,22195,22229,4087,34,4121,completed
8924,rigid,18108,22195,22214,4087,19,4106,completed
8925,rigid,18108,22195,22213,4087,18,4105,completed
8926,rigid,18108,22196,22215,4088,19,4107,completed
8927,rigid,18108,22196,22220,4088,24,4112,completed
8928,rigid,18108,22196,22221,4088,25,4113,completed
8929,rigid,18108,22196,22214,4088,18,4106,completed
8930,rigid,18108,22196,22204,4088,8,4096,completed
8931,rigid,18108,22196,22205,4088,9,4097,completed
8932,rigid,18108,22196,22223,4088,27,4115,completed
8933,rigid,18108,22197,22224,4089,27,4116,completed
8934,rigid,18108,22197,22225,4089,28,4117,completed
8935,rigid,18108,22197,22214,4089,17,4106,completed
8936,rigid,18108,22197,22229,4089,32,4121,completed
8937,rigid,18108,22197,22233,4089,36,4125,completed
8938,rigid,18108,22197,22215,4089,18,4107,completed
8939,rigid,18108,22197,22235,4089,38,4127,completed
8940,rigid,18108,22197,22234,4089,37,4126,completed
8941,rigid,18108,22197,22233,4089,36,4125,completed
8942,rigid,18108,22198,22215,4090,17,4107,completed
8943,rigid,18108,22198,22213,4090,15,4105,completed
8944,rigid,18108,22198,22215,4090,17,4107,completed
8945,rigid,18108,22198,22217,4090,19,4109,completed
8946,rigid,18108,22198,22214,4090,16,4106,completed
8947,rigid,18108,22198,22212,4090,14,4104,completed
8948,rigid,18108,22198,22213,4090,15,4105,completed
8949,rigid,18108,22199,22216,4091,17,4108,completed
8950,rigid,18108,22199,22217,4091,18,4109,completed
8951,rigid,18108,22199,22212,4091,13,4104,completed
8952,rigid,18108,22199,22212,4091,13,4104,completed
8953,rigid,18108,22199,22210,4091,11,4102,completed
8954,rigid,18108,22200,22211,4092,11,4103,completed
8955,rigid,18108,22200,22212,4092,12,4104,completed
8956,rigid,18108,22200,22216,4092,16,4108,completed
8957,rigid,18108,22200,22225,4092,25,4117,completed
8958,rigid,18108,22200,22225,4092,25,4117,completed
8959,rigid,18108,22200,22222,4092,22,4114,completed
8960,rigid,18108,22201,22219,4093,18,4111,completed
8961,rigid,18108,22201,22220,4093,19,4112,completed
8962,rigid,18108,22201,22219,4093,18,4111,completed
8963,rigid,18108,22201,22217,4093,16,4109,completed
8964,rigid,18108,22202,22215,4094,13,4107,completed
8965,rigid,18108,22202,22214,4094,12,4106,completed
8966,rigid,18108,22202,22214,4094,12,4106,completed
8967,rigid,18108,22202,22220,4094,18,4112,completed
8968,rigid,18108,22203,22220,4095,17,4112,completed
8969,rigid,18108,22203,22221,4095,18,4113,completed
8970,rigid,18108,22203,22225,4095,22,4117,completed
8971,rigid,18108,22204,22228,4096,24,4120,completed
8972,rigid,18108,22204,22223,4096,19,4115,completed
8973,rigid,18108,22204,22221,4096,17,4113,completed
8974,rigid,18108,22204,22224,4096,20,4116,completed
8975,rigid,18108,22204,22222,4096,18,4114,completed
8976,rigid,18108,22205,22230,4097,25,4122,completed
8977,rigid,18108,22205,22223,4097,18,4115,completed
8978,rigid,18108,22205,22224,4097,19,4116,completed
8979,rigid,18108,22205,22221,4097,16,4113,completed
8980,rigid,18108,22205,22216,4097,11,4108,completed
8981,rigid,18108,22205,22218,4097,13,4110,completed
8982,rigid,18108,22205,22221,4097,16,4113,completed
8983,rigid,18108,22205,22227,4097,22,4119,completed
8984,rigid,18108,22205,22223,4097,18,4115,completed
8985,rigid,18108,22205,22221,4097,16,4113,completed
8986,rigid,18108,22206,22222,4098,16,4114,completed
8987,rigid,18108,22206,22230,4098,24,4122,completed
8988,rigid,18108,22206,22225,4098,19,4117,completed
8989,rigid,18108,22206,22226,4098,20,4118,completed
8990,rigid,18108,22206,22221,4098,15,4113,completed
8991,rigid,18108,22207,22218,4099,11,4110,completed
8992,rigid,18108,22207,22231,4099,24,4123,completed
8993,rigid,18108,22207,22227,4099,20,4119,completed
8994,rigid,18108,22208,22226,4100,18,4118,completed
8995,rigid,18108,22208,22224,4100,16,4116,completed
8996,rigid,18108,22208,22230,4100,22,4122,completed
8997,rigid,18108,22209,22223,4101,14,4115,completed
8998,rigid,18108,22209,22224,4101,15,4116,completed
8999,rigid,18108,22209,22226,4101,17,4118,completed
9000,rigid,18108,22209,22226,4101,17,4118,completed
9001,rigid,18108,22209,22222,4101,13,4114,completed
9002,rigid,18108,22209,22230,4101,21,4122,completed
9003,rigid,18108,22209,22222,4101,13,4114,completed
9004,rigid,18108,22209,22226,4101,17,4118,completed
9005,rigid,18108,22209,22222,4101,13,4114,completed
9006,rigid,18108,22210,22230,4102,20,4122,completed
9007,rigid,18108,22210,22232,4102,22,4124,completed
9008,rigid,18108,22210,22223,4102,13,4115,completed
9009,rigid,18108,22210,22228,4102,18,4120,completed
9010,rigid,18108,22210,22230,4102,20,4122,completed
9011,rigid,18108,22210,22228,4102,18,4120,completed
9012,rigid,18108,22211,22224,4103,13,4116,completed
9013,rigid,18108,22211,22224,4103,13,4116,completed
9014,rigid,18108,22211,22227,4103,16,4119,completed
9015,rigid,18108,22211,22222,4103,11,4114,completed
9016,rigid,18108,22211,22221,4103,10,4113,completed
9017,rigid,18108,22212,22213,4104,1,4105,completed
9018,rigid,18109,22214,22236,4105,22,4127,completed
9019,rigid,18110,22216,22250,4106,34,4140,completed
9020,rigid,18110,22220,22237,4110,17,4127,completed
9021,rigid,18111,22221,22235,4110,14,4124,completed
9022,rigid,18113,22221,22223,4108,2,4110,completed
9023,rigid,18118,22222,22224,4104,2,4106,completed
9024,rigid,18119,22223,22244,4104,21,4125,completed
9025,rigid,18124,22224,22229,4100,5,4105,completed
9026,rigid,18124,22224,23357,4100,1133,5233,completed
9027,rigid,18124,22225,23096,4101,871,4972,completed
9028,rigid,18124,22225,23404,4101,1179,5280,completed
9029,rigid,18125,22228,22239,4103,11,4114,completed
9030,rigid,18129,22229,22231,4100,2,4102,completed
9031,rigid,18132,22229,22231,4097,2,4099,completed
9032,rigid,18135,22229,22265,4094,36,4130,completed
9033,rigid,18153,22229,22260,4076,31,4107,completed
9034,rigid,18158,22231,23180,4073,949,5022,completed
9035,rigid,18158,22235,23572,4077,1337,5414,completed
9036,rigid,18158,22236,24016,4078,1780,5858,completed
9037,rigid,18158,22237,23610,4079,1373,5452,completed
9038,rigid,18158,22239,23799,4081,1560,5641,completed
9039,rigid,18165,22244,22267,4079,23,4102,completed
9040,rigid,18168,22244,22256,4076,12,4088,completed
9041,rigid,18169,22244,22256,4075,12,4087,completed
9042,rigid,18169,22244,22256,4075,12,4087,completed
9043,rigid,18169,22244,22256,4075,12,4087,completed
9044,rigid,18169,22244,22256,4075,12,4087,completed
9045,rigid,18177,22244,22256,4067,12,4079,completed
9046,rigid,18178,22250,22252,4072,2,4074,completed
9047,rigid,18179,22250,22613,4071,363,4434,completed
9048,rigid,18181,22250,22613,4069,363,4432,completed
9049,rigid,18187,22250,22615,4063,365,4428,completed
9050,rigid,18187,22250,22613,4063,363,4426,completed
9051,rigid,18187,22252,22613,4065,361,4426,completed
9052,rigid,18187,22256,22617,4069,361,4430,completed
9053,rigid,18188,22256,22618,4068,362,4430,completed
9054,rigid,18188,22256,22620,4068,364,4432,completed
9055,rigid,18188,22256,22619,4068,363,4431,completed
9056,rigid,18188,22256,22616,4068,360,4428,completed
9057,rigid,18188,22256,22621,4068,365,4433,completed
9058,rigid,18188,22260,22624,4072,364,4436,completed
9059,rigid,18188,22260,22624,4072,364,4436,completed
9060,rigid,18193,22260,22262,4067,2,4069,completed
9061,rigid,18195,22262,22280,4067,18,4085,completed
9062,rigid,18203,22262,22271,4059,9,4068,completed
9063,rigid,18203,22262,22269,4059,7,4066,completed
9064,rigid,18203,22265,22279,4062,14,4076,completed
9065,rigid,18203,22265,22276,4062,11,4073,completed
9066,rigid,18203,22265,22279,4062,14,4076,completed
9067,rigid,18203,22265,22282,4062,17,4079,completed
9068,rigid,18203,22265,22279,4062,14,4076,completed
9069,rigid,18203,22265,22278,4062,13,4075,completed
9070,rigid,18203,22265,22276,4062,11,4073,completed
9071,rigid,18203,22265,22277,4062,12,4074,completed
9072,rigid,18203,22265,22276,4062,11,4073,completed
9073,rigid,18203,22265,22281,4062,16,4078,completed
9074,rigid,18203,22265,22282,4062,17,4079,completed
9075,rigid,18203,22265,22283,4062,18,4080,completed
9076,rigid,18203,22265,22280,4062,15,4077,completed
9077,rigid,18203,22265,22282,4062,17,4079,completed
9078,rigid,18203,22265,22281,4062,16,4078,completed
9079,rigid,18203,22265,22278,4062,13,4075,completed
9080,rigid,18203,22265,22276,4062,11,4073,completed
9081,rigid,18203,22265,22277,4062,12,4074,completed
9082,rigid,18203,22265,22278,4062,13,4075,completed
9083,rigid,18203,22265,22277,4062,12,4074,completed
9084,rigid,18203,22265,22281,4062,16,4078,completed
9085,rigid,18203,22265,22280,4062,15,4077,completed
9086,rigid,18203,22265,22280,4062,15,4077,completed
9087,rigid,18203,22265,22282,4062,17,4079,completed
9088,rigid,18203,22265,22281,4062,16,4078,completed
9089,rigid,18203,22265,22279,4062,14,4076,completed
9090,rigid,18203,22265,22280,4062,15,4077,completed
9091,rigid,18203,22265,22273,4062,8,4070,completed
9092,rigid,18203,22265,22274,4062,9,4071,completed
9093,rigid,18203,22265,22281,4062,16,4078,completed
9094,rigid,18203,22265,22281,4062,16,4078,completed
9095,rigid,18203,22265,22280,4062,15,4077,completed
9096,rigid,18203,22265,22280,4062,15,4077,completed
9097,rigid,18203,22265,22279,4062,14,4076,completed
9098,rigid,18203,22265,22275,4062,10,4072,completed
9099,rigid,18203,22265,22275,4062,10,4072,completed
9100,rigid,18203,22265,22277,4062,12,4074,completed
9101,rigid,18203,22265,22276,4062,11,4073,completed
9102,rigid,18203,22265,22279,4062,14,4076,completed
9103,rigid,18203,22265,22281,4062,16,4078,completed
9104,rigid,18203,22265,22278,4062,13,4075,completed
9105,rigid,18203,22265,22280,4062,15,4077,completed
9106,rigid,18203,22265,22282,4062,17,4079,completed
9107,rigid,18203,22265,22282,4062,17,4079,completed
9108,rigid,18203,22265,22282,4062,17,4079,completed
9109,rigid,18203,22265,22279,4062,14,4076,completed
9110,rigid,18203,22265,22278,4062,13,4075,completed
9111,rigid,18203,22265,22284,4062,19,4081,completed
9112,rigid,18203,22265,22282,4062,17,4079,completed
9113,rigid,18203,22267,22281,4064,14,4078,completed
9114,rigid,18203,22267,22281,4064,14,4078,completed
9115,rigid,18203,22267,22280,4064,13,4077,completed
9116,rigid,18203,22267,22280,4064,13,4077,completed
9117,rigid,18203,22267,22282,4064,15,4079,completed
9118,rigid,18203,22267,22282,4064,15,4079,completed
9119,rigid,18203,22267,22283,4064,16,4080,completed
9120,rigid,18203,22267,22278,4064,11,4075,completed
9121,rigid,18203,22267,22280,4064,13,4077,completed
9122,rigid,18203,22267,22280,4064,13,4077,completed
9123,rigid,18203,22267,22285,4064,18,4082,completed
9124,rigid,18203,22267,22285,4064,18,4082,completed
9125,rigid,18203,22267,22287,4064,20,4084,completed
9126,rigid,18203,22267,22279,4064,12,4076,completed
9127,rigid,18203,22267,22283,4064,16,4080,completed
9128,rigid,18203,22267,22280,4064,13,4077,completed
9129,rigid,18203,22269,22282,4066,13,4079,completed
9130,rigid,18203,22271,22282,4068,11,4079,completed
9131,rigid,18203,22272,22284,4069,12,4081,completed
9132,rigid,18203,22272,22283,4069,11,4080,completed
9133,rigid,18203,22272,22279,4069,7,4076,completed
9134,rigid,18203,22272,22279,4069,7,4076,completed
9135,rigid,18203,22273,22282,4070,9,4079,completed
9136,rigid,18203,22274,22282,4071,8,4079,completed
9137,rigid,18203,22274,22280,4071,6,4077,completed
9138,rigid,18203,22274,22282,4071,8,4079,completed
9139,rigid,18203,22274,22282,4071,8,4079,completed
9140,rigid,18203,22274,22283,4071,9,4080,completed
9141,rigid,18203,22275,22284,4072,9,4081,completed
9142,rigid,18203,22275,22283,4072,8,4080,completed
9143,rigid,18203,22276,22285,4073,9,4082,completed
9144,rigid,18203,22276,22283,4073,7,4080,completed
9145,rigid,18203,22276,22283,4073,7,4080,completed
9146,rigid,18203,22276,22283,4073,7,4080,completed
9147,rigid,18203,22276,22283,4073,7,4080,completed
9148,rigid,18203,22277,22284,4074,7,4081,completed
9149,rigid,18203,22277,22284,4074,7,4081,completed
9150,rigid,18203,22277,22286,4074,9,4083,completed
9151,rigid,18203,22277,22284,4074,7,4081,completed
9152,rigid,18203,22278,22287,4075,9,4084,completed
9153,rigid,18203,22278,22287,4075,9,4084,completed
9154,rigid,18203,22278,22283,4075,5,4080,completed
9155,rigid,18203,22278,22285,4075,7,4082,completed
9156,rigid,18203,22278,22284,4075,6,4081,completed
9157,rigid,18203,22278,22288,4075,10,4085,completed
9158,rigid,18203,22279,22289,4076,10,4086,completed
9159,rigid,18203,22279,22290,4076,11,4087,completed
9160,rigid,18203,22279,22289,4076,10,4086,completed
9161,rigid,18203,22279,22289,4076,10,4086,completed
9162,rigid,18203,22279,22290,4076,11,4087,completed
9163,rigid,18203,22279,22293,4076,14,4090,completed
9164,rigid,18203,22279,22292,4076,13,4089,completed
9165,rigid,18203,22279,22291,4076,12,4088,completed
9166,rigid,18203,22279,22290,4076,11,4087,completed
9167,rigid,18203,22279,22291,4076,12,4088,completed
9168,rigid,18203,22280,22290,4077,10,4087,completed
9169,rigid,18203,22280,22291,4077,11,4088,completed
9170,rigid,18203,22280,22291,4077,11,4088,completed
9171,rigid,18203,22280,22290,4077,10,4087,completed
9172,rigid,18203,22280,22293,4077,13,4090,completed
9173,rigid,18203,22280,22290,4077,10,4087,completed
9174,rigid,18203,22280,22290,4077,10,4087,completed
9175,rigid,18203,22280,22290,4077,10,4087,completed
9176,rigid,18203,22280,22292,4077,12,4089,completed
9177,rigid,18203,22280,22290,4077,10,4087,completed
9178,rigid,18203,22280,22292,4077,12,4089,completed
9179,rigid,18203,22280,22292,4077,12,4089,completed
9180,rigid,18203,22280,22291,4077,11,4088,completed
9181,rigid,18203,22280,22291,4077,11,4088,completed
9182,rigid,18203,22280,22291,4077,11,4088,completed
9183,rigid,18203,22280,22294,4077,14,4091,completed
9184,rigid,18203,22280,22290,4077,10,4087,completed
9185,rigid,18203,22280,22291,4077,11,4088,completed
9186,rigid,18203,22280,22292,4077,12,4089,completed
9187,rigid,18203,22280,22291,4077,11,4088,completed
9188,rigid,18203,22280,22292,4077,12,4089,completed
9189,rigid,18203,22281,22292,4078,11,4089,completed
9190,rigid,18203,22281,22292,4078,11,4089,completed
9191,rigid,18203,22281,22290,4078,9,4087,completed
9192,rigid,18203,22281,22288,4078,7,4085,completed
9193,rigid,18203,22281,22286,4078,5,4083,completed
9194,rigid,18203,22281,22290,4078,9,4087,completed
9195,rigid,18203,22281,22289,4078,8,4086,completed
9196,rigid,18203,22281,22290,4078,9,4087,completed
9197,rigid,18203,22281,22290,4078,9,4087,completed
9198,rigid,18203,22282,22291,4079,9,4088,completed
9199,rigid,18203,22282,22288,4079,6,4085,completed
9200,rigid,18203,22282,22289,4079,7,4086,completed
9201,rigid,18203,22282,22289,4079,7,4086,completed
9202,rigid,18203,22282,22289,4079,7,4086,completed
9203,rigid,18203,22282,22291,4079,9,4088,completed
9204,rigid,18203,22282,22291,4079,9,4088,completed
9205,rigid,18203,22282,22291,4079,9,4088,completed
9206,rigid,18203,22282,22288,4079,6,4085,completed
9207,rigid,18203,22282,22289,4079,7,4086,completed
9208,rigid,18203,22282,22288,4079,6,4085,completed
9209,rigid,18203,22282,22289,4079,7,4086,completed
9210,rigid,18203,22282,22291,4079,9,4088,completed
9211,rigid,18203,22282,22291,4079,9,4088,completed
9212,rigid,18203,22282,22290,4079,8,4087,completed
9213,rigid,18203,22282,22290,4079,8,4087,completed
9214,rigid,18203,22282,22291,4079,9,4088,completed
9215,rigid,18203,22282,22290,4079,8,4087,completed
9216,rigid,18203,22282,22291,4079,9,4088,completed
9217,rigid,18203,22282,22291,4079,9,4088,completed
9218,rigid,18203,22282,22287,4079,5,4084,completed
9219,rigid,18203,22282,22289,4079,7,4086,completed
9220,rigid,18203,22282,22287,4079,5,4084,completed
9221,rigid,18203,22282,22289,4079,7,4086,completed
9222,rigid,18203,22283,22288,4080,5,4085,completed
9223,rigid,18203,22283,22289,4080,6,4086,completed
9224,rigid,18203,22283,22292,4080,9,4089,completed
9225,rigid,18203,22283,22291,4080,8,4088,completed
9226,rigid,18203,22283,22292,4080,9,4089,completed
9227,rigid,18203,22283,22294,4080,11,4091,completed
9228,rigid,18203,22283,22294,4080,11,4091,completed
9229,rigid,18203,22283,22296,4080,13,4093,completed
9230,rigid,18203,22283,22295,4080,12,4092,completed
9231,rigid,18203,22283,22297,4080,14,4094,completed
9232,rigid,18203,22283,22293,4080,10,4090,completed
9233,rigid,18203,22284,22294,4081,10,4091,completed
9234,rigid,18203,22284,22294,4081,10,4091,completed
9235,rigid,18203,22284,22295,4081,11,4092,completed
9236,rigid,18203,22284,22295,4081,11,4092,completed
9237,rigid,18203,22284,22295,4081,11,4092,completed
9238,rigid,18203,22284,22296,4081,12,4093,completed
9239,rigid,18203,22284,22294,4081,10,4091,completed
9240,rigid,18203,22285,22295,4082,10,4092,completed
9241,rigid,18203,22285,22295,4082,10,4092,completed
9242,rigid,18203,22285,22295,4082,10,4092,completed
9243,rigid,18203,22285,22296,4082,11,4093,completed
9244,rigid,18203,22286,22297,4083,11,4094,completed
9245,rigid,18203,22286,22296,4083,10,4093,completed
9246,rigid,18203,22287,22298,4084,11,4095,completed
9247,rigid,18203,22287,22297,4084,10,4094,completed
9248,rigid,18203,22287,22297,4084,10,4094,completed
9249,rigid,18203,22287,22297,4084,10,4094,completed
9250,rigid,18203,22287,22299,4084,12,4096,completed
9251,rigid,18203,22287,22297,4084,10,4094,completed
9252,rigid,18203,22287,22297,4084,10,4094,completed
9253,rigid,18203,22287,22299,4084,12,4096,completed
9254,rigid,18203,22287,22297,4084,10,4094,completed
9255,rigid,18203,22287,22296,4084,9,4093,completed
9256,rigid,18203,22287,22293,4084,6,4090,completed
9257,rigid,18203,22287,22296,4084,9,4093,completed
9258,rigid,18203,22287,22296,4084,9,4093,completed
9259,rigid,18203,22287,22295,4084,8,4092,completed
9260,rigid,18203,22287,22296,4084,9,4093,completed
9261,rigid,18203,22287,22291,4084,4,4088,completed
9262,rigid,18203,22287,22292,4084,5,4089,completed
9263,rigid,18203,22287,22296,4084,9,4093,completed
9264,rigid,18203,22287,22293,4084,6,4090,completed
9265,rigid,18203,22287,22293,4084,6,4090,completed
9266,rigid,18203,22287,22295,4084,8,4092,completed
9267,rigid,18203,22288,22297,4085,9,4094,completed
9268,rigid,18203,22288,22297,4085,9,4094,completed
9269,rigid,18203,22288,22298,4085,10,4095,completed
9270,rigid,18203,22288,22298,4085,10,4095,completed
9271,rigid,18203,22288,22299,4085,11,4096,completed
9272,rigid,18203,22288,22301,4085,13,4098,completed
9273,rigid,18203,22289,22299,4086,10,4096,completed
9274,rigid,18203,22289,22299,4086,10,4096,completed
9275,rigid,18203,22289,22300,4086,11,4097,completed
9276,rigid,18203,22289,22302,4086,13,4099,completed
9277,rigid,18203,22289,22299,4086,10,4096,completed
9278,rigid,18206,22289,22290,4083,1,4084,completed
9279,rigid,18206,22290,22292,4084,2,4086,completed
9280,rigid,18206,22290,22291,4084,1,4085,completed
9281,rigid,18206,22290,22291,4084,1,4085,completed
9282,rigid,18207,22290,22291,4083,1,4084,completed
9283,rigid,18207,22290,22291,4083,1,4084,completed
9284,rigid,18213,22291,22321,4078,30,4108,completed
9285,rigid,18218,22291,22298,4073,7,4080,completed
9286,rigid,18218,22291,22298,4073,7,4080,completed
9287,rigid,18218,22291,22298,4073,7,4080,completed
9288,rigid,18218,22291,22298,4073,7,4080,completed
9289,rigid,18218,22291,22298,4073,7,4080,completed
9290,rigid,18218,22291,22298,4073,7,4080,completed
9291,rigid,18218,22291,22298,4073,7,4080,completed
9292,rigid,18218,22292,22299,4074,7,4081,completed
9293,rigid,18218,22292,22299,4074,7,4081,completed
9294,rigid,18218,22292,22299,4074,7,4081,completed
9295,rigid,18218,22293,22300,4075,7,4082,completed
9296,rigid,18218,22293,22300,4075,7,4082,completed
9297,rigid,18218,22294,22301,4076,7,4083,completed
9298,rigid,18218,22295,22302,4077,7,4084,completed
9299,rigid,18218,22295,22302,4077,7,4084,completed
9300,rigid,18218,22295,22302,4077,7,4084,completed
9301,rigid,18219,22297,23011,4078,714,4792,completed
9302,rigid,18220,22298,24663,4078,2365,6443,completed
9303,rigid,18221,22298,23219,4077,921,4998,completed
9304,rigid,18222,22299,22774,4077,475,4552,completed
9305,rigid,18222,22300,22303,4078,3,4081,completed
9306,rigid,18222,22302,23212,4080,910,4990,completed
9307,rigid,18223,22302,22637,4079,335,4414,completed
9308,rigid,18223,22302,22390,4079,88,4167,completed
9309,rigid,18223,22303,22375,4080,72,4152,completed
9310,rigid,18223,22306,22357,4083,51,4134,completed
9311,rigid,18223,22316,23410,4093,1094,5187,completed
9312,rigid,18226,22321,24686,4095,2365,6460,completed
9313,rigid,18237,22357,22387,4120,30,4150,completed
9314,rigid,18239,22375,22387,4136,12,4148,completed
9315,rigid,18239,22375,22387,4136,12,4148,completed
9316,rigid,18239,22387,22399,4148,12,4160,completed
9317,rigid,18239,22387,22399,4148,12,4160,completed
9318,rigid,18239,22387,22399,4148,12,4160,completed
9319,rigid,18239,22389,22401,4150,12,4162,completed
9320,rigid,18239,22390,22402,4151,12,4163,completed
9321,rigid,18239,22394,22406,4155,12,4167,completed
9322,rigid,18239,22396,22408,4157,12,4169,completed
9323,rigid,18239,22399,22411,4160,12,4172,completed
9324,rigid,18239,22399,22411,4160,12,4172,completed
9325,rigid,18239,22399,22411,4160,12,4172,completed
9326,rigid,18239,22401,22413,4162,12,4174,completed
9327,rigid,18239,22401,22413,4162,12,4174,completed
9328,rigid,18239,22402,22414,4163,12,4175,completed
9329,rigid,18239,22406,22418,4167,12,4179,completed
9330,rigid,18264,22406,22643,4142,237,4379,completed
9331,rigid,18264,22408,22644,4144,236,4380,completed
9332,rigid,18264,22410,22645,4146,235,4381,completed
9333,rigid,18264,22410,22512,4146,102,4248,completed
9334,rigid,18264,22410,22651,4146,241,4387,completed
9335,rigid,18264,22410,22652,4146,242,4388,completed
9336,rigid,18264,22410,22552,4146,142,4288,completed
9337,rigid,18264,22410,22652,4146,242,4388,completed
9338,rigid,18264,22410,22651,4146,241,4387,completed
9339,rigid,18264,22410,22647,4146,237,4383,completed
9340,rigid,18264,22410,22647,4146,237,4383,completed
9341,rigid,18264,22410,22647,4146,237,4383,completed
9342,rigid,18265,22410,24880,4145,2470,6615,completed
9343,rigid,18268,22410,22414,4142,4,4146,completed
9344,rigid,18268,22410,22414,4142,4,4146,completed
9345,rigid,18268,22410,22414,4142,4,4146,completed
9346,rigid,18268,22410,22415,4142,5,4147,completed
9347,rigid,18268,22410,22418,4142,8,4150,completed
9348,rigid,18268,22411,22418,4143,7,4150,completed
9349,rigid,18268,22411,22417,4143,6,4149,completed
9350,rigid,18268,22411,22418,4143,7,4150,completed
9351,rigid,18268,22411,22415,4143,4,4147,completed
9352,rigid,18268,22411,22417,4143,6,4149,completed
9353,rigid,18268,22411,22416,4143,5,4148,completed
9354,rigid,18268,22411,22417,4143,6,4149,completed
9355,rigid,18268,22411,22420,4143,9,4152,completed
9356,rigid,18268,22411,22420,4143,9,4152,completed
9357,rigid,18268,22411,22418,4143,7,4150,completed
9358,rigid,18268,22411,22416,4143,5,4148,completed
9359,rigid,18268,22411,22418,4143,7,4150,completed
9360,rigid,18268,22413,22421,4145,8,4153,completed
9361,rigid,18268,22413,22420,4145,7,4152,completed
9362,rigid,18268,22413,22422,4145,9,4154,completed
9363,rigid,18268,22413,22421,4145,8,4153,completed
9364,rigid,18268,22413,22420,4145,7,4152,completed
9365,rigid,18268,22413,22421,4145,8,4153,completed
9366,rigid,18268,22413,22422,4145,9,4154,completed
9367,rigid,18268,22413,22422,4145,9,4154,completed
9368,rigid,18268,22414,22423,4146,9,4155,completed
9369,rigid,18268,22414,22424,4146,10,4156,completed
9370,rigid,18268,22414,22424,4146,10,4156,completed
9371,rigid,18268,22414,22426,4146,12,4158,completed
9372,rigid,18268,22414,22424,4146,10,4156,completed
9373,rigid,18268,22414,22424,4146,10,4156,completed
9374,rigid,18268,22414,22425,4146,11,4157,completed
9375,rigid,18268,22415,22426,4147,11,4158,completed
9376,rigid,18268,22415,22425,4147,10,4157,completed
9377,rigid,18268,22416,22420,4148,4,4152,completed
9378,rigid,18268,22416,22419,4148,3,4151,completed
9379,rigid,18268,22417,22422,4149,5,4154,completed
9380,rigid,18268,22417,22423,4149,6,4155,completed
9381,rigid,18268,22417,22422,4149,5,4154,completed
9382,rigid,18268,22418,22423,4150,5,4155,completed
9383,rigid,18268,22418,22426,4150,8,4158,completed
9384,rigid,18268,22418,22426,4150,8,4158,completed
9385,rigid,18268,22418,22426,4150,8,4158,completed
9386,rigid,18268,22418,22427,4150,9,4159,completed
9387,rigid,18268,22418,22426,4150,8,4158,completed
9388,rigid,18268,22418,22423,4150,5,4155,completed
9389,rigid,18268,22418,22426,4150,8,4158,completed
9390,rigid,18268,22418,22426,4150,8,4158,completed
9391,rigid,18268,22419,22427,4151,8,4159,completed
9392,rigid,18268,22420,22426,4152,6,4158,completed
9393,rigid,18268,22420,22424,4152,4,4156,completed
9394,rigid,18268,22420,22426,4152,6,4158,completed
9395,rigid,18268,22420,22425,4152,5,4157,completed
9396,rigid,18268,22420,22426,4152,6,4158,completed
9397,rigid,18268,22420,22428,4152,8,4160,completed
9398,rigid,18268,22420,22427,4152,7,4159,completed
9399,rigid,18268,22420,22428,4152,8,4160,completed
9400,rigid,18268,22420,22429,4152,9,4161,completed
9401,rigid,18268,22421,22429,4153,8,4161,completed
9402,rigid,18268,22421,22424,4153,3,4156,completed
9403,rigid,18268,22421,22430,4153,9,4162,completed
9404,rigid,18268,22422,22431,4154,9,4163,completed
9405,rigid,18268,22422,22425,4154,3,4157,completed
9406,rigid,18268,22422,22430,4154,8,4162,completed
9407,rigid,18268,22422,22426,4154,4,4158,completed
9408,rigid,18268,22422,22428,4154,6,4160,completed
9409,rigid,18268,22423,22428,4155,5,4160,completed
9410,rigid,18268,22423,22429,4155,6,4161,completed
9411,rigid,18268,22423,22428,4155,5,4160,completed
9412,rigid,18268,22423,22427,4155,4,4159,completed
9413,rigid,18268,22424,22428,4156,4,4160,completed
9414,rigid,18268,22424,22428,4156,4,4160,completed
9415,rigid,18268,22424,22428,4156,4,4160,completed
9416,rigid,18268,22424,22433,4156,9,4165,completed
9417,rigid,18268,22424,22430,4156,6,4162,completed
9418,rigid,18268,22424,22430,4156,6,4162,completed
9419,rigid,18268,22425,22432,4157,7,4164,completed
9420,rigid,18268,22425,22436,4157,11,4168,completed
9421,rigid,18268,22425,22435,4157,10,4167,completed
9422,rigid,18268,22425,22435,4157,10,4167,completed
9423,rigid,18268,22426,22430,4158,4,4162,completed
9424,rigid,18268,22426,22431,4158,5,4163,completed
9425,rigid,18268,22426,22430,4158,4,4162,completed
9426,rigid,18268,22426,22430,4158,4,4162,completed
9427,rigid,18268,22426,22435,4158,9,4167,completed
9428,rigid,18268,22426,22434,4158,8,4166,completed
9429,rigid,18268,22426,22435,4158,9,4167,completed
9430,rigid,18268,22426,22434,4158,8,4166,completed
9431,rigid,18268,22426,22434,4158,8,4166,completed
9432,rigid,18268,22426,22430,4158,4,4162,completed
9433,rigid,18268,22426,22432,4158,6,4164,completed
9434,rigid,18268,22426,22431,4158,5,4163,completed
9435,rigid,18268,22426,22433,4158,7,4165,completed
9436,rigid,18268,22426,22432,4158,6,4164,completed
9437,rigid,18268,22426,22431,4158,5,4163,completed
9438,rigid,18268,22426,22431,4158,5,4163,completed
9439,rigid,18268,22426,22432,4158,6,4164,completed
9440,rigid,18268,22426,22433,4158,7,4165,completed
9441,rigid,18268,22426,22434,4158,8,4166,completed
9442,rigid,18268,22426,22434,4158,8,4166,completed
9443,rigid,18268,22427,22435,4159,8,4167,completed
9444,rigid,18268,22427,22436,4159,9,4168,completed
9445,rigid,18268,22427,22434,4159,7,4166,completed
9446,rigid,18268,22427,22434,4159,7,4166,completed
9447,rigid,18268,22428,22430,4160,2,4162,completed
9448,rigid,18268,22428,22430,4160,2,4162,completed
9449,rigid,18268,22428,22432,4160,4,4164,completed
9450,rigid,18268,22428,22433,4160,5,4165,completed
9451,rigid,18268,22428,22432,4160,4,4164,completed
9452,rigid,18268,22428,22431,4160,3,4163,completed
9453,rigid,18268,22428,22436,4160,8,4168,completed
9454,rigid,18268,22428,22437,4160,9,4169,completed
9455,rigid,18268,22429,22437,4161,8,4169,completed
9456,rigid,18268,22429,22435,4161,6,4167,completed
9457,rigid,18268,22429,22433,4161,4,4165,completed
9458,rigid,18268,22430,22438,4162,8,4170,completed
9459,rigid,18268,22430,22438,4162,8,4170,completed
9460,rigid,18268,22430,22437,4162,7,4169,completed
9461,rigid,18268,22430,22435,4162,5,4167,completed
9462,rigid,18268,22430,22433,4162,3,4165,completed
9463,rigid,18268,22430,22436,4162,6,4168,completed
9464,rigid,18268,22430,22436,4162,6,4168,completed
9465,rigid,18268,22430,22438,4162,8,4170,completed
9466,rigid,18268,22430,22438,4162,8,4170,completed
9467,rigid,18268,22430,22435,4162,5,4167,completed
9468,rigid,18268,22431,22440,4163,9,4172,completed
9469,rigid,18268,22431,22436,4163,5,4168,completed
9470,rigid,18268,22431,22435,4163,4,4167,completed
9471,rigid,18268,22431,22440,4163,9,4172,completed
9472,rigid,18268,22431,22442,4163,11,4174,completed
9473,rigid,18268,22431,22442,4163,11,4174,completed
9474,rigid,18268,22432,22442,4164,10,4174,completed
9475,rigid,18268,22432,22443,4164,11,4175,completed
9476,rigid,18268,22432,22442,4164,10,4174,completed
9477,rigid,18268,22432,22443,4164,11,4175,completed
9478,rigid,18268,22432,22443,4164,11,4175,completed
9479,rigid,18268,22432,22442,4164,10,4174,completed
9480,rigid,18268,22433,22444,4165,11,4176,completed
9481,rigid,18268,22433,22444,4165,11,4176,completed
9482,rigid,18268,22433,22438,4165,5,4170,completed
9483,rigid,18268,22433,22439,4165,6,4171,completed
9484,rigid,18268,22433,22439,4165,6,4171,completed
9485,rigid,18268,22433,22439,4165,6,4171,completed
9486,rigid,18268,22434,22438,4166,4,4170,completed
9487,rigid,18268,22434,22438,4166,4,4170,completed
9488,rigid,18268,22434,22438,4166,4,4170,completed
9489,rigid,18268,22434,22438,4166,4,4170,completed
9490,rigid,18268,22434,22439,4166,5,4171,completed
9491,rigid,18268,22434,22442,4166,8,4174,completed
9492,rigid,18268,22434,22440,4166,6,4172,completed
9493,rigid,18268,22435,22439,4167,4,4171,completed
9494,rigid,18268,22435,22440,4167,5,4172,completed
9495,rigid,18268,22435,22438,4167,3,4170,completed
9496,rigid,18268,22435,22439,4167,4,4171,completed
9497,rigid,18268,22435,22439,4167,4,4171,completed
9498,rigid,18268,22435,22439,4167,4,4171,completed
9499,rigid,18268,22435,22444,4167,9,4176,completed
9500,rigid,18268,22435,22443,4167,8,4175,completed
9501,rigid,18268,22435,22443,4167,8,4175,completed
9502,rigid,18268,22436,22443,4168,7,4175,completed
9503,rigid,18268,22436,22442,4168,6,4174,completed
9504,rigid,18268,22436,22442,4168,6,4174,completed
9505,rigid,18268,22436,22441,4168,5,4173,completed
9506,rigid,18268,22436,22442,4168,6,4174,completed
9507,rigid,18268,22436,22441,4168,5,4173,completed
9508,rigid,18268,22437,22442,4169,5,4174,completed
9509,rigid,18268,22437,22443,4169,6,4175,completed
9510,rigid,18268,22437,22442,4169,5,4174,completed
9511,rigid,18268,22438,22446,4170,8,4178,completed
9512,rigid,18268,22438,22446,4170,8,4178,completed
9513,rigid,18268,22438,22447,4170,9,4179,completed
9514,rigid,18268,22438,22447,4170,9,4179,completed
9515,rigid,18268,22438,22447,4170,9,4179,completed
9516,rigid,18268,22438,22445,4170,7,4177,completed
9517,rigid,18268,22438,22448,4170,10,4180,completed
9518,rigid,18268,22438,22448,4170,10,4180,completed
9519,rigid,18268,22438,22448,4170,10,4180,completed
9520,rigid,18268,22438,22445,4170,7,4177,completed
9521,rigid,18268,22439,22441,4171,2,4173,completed
9522,rigid,18268,22439,22443,4171,4,4175,completed
9523,rigid,18268,22439,22441,4171,2,4173,completed
9524,rigid,18268,22439,22443,4171,4,4175,completed
9525,rigid,18268,22439,22443,4171,4,4175,completed
9526,rigid,18268,22439,22443,4171,4,4175,completed
9527,rigid,18268,22439,22444,4171,5,4176,completed
9528,rigid,18268,22439,22445,4171,6,4177,completed
9529,rigid,18268,22440,22448,4172,8,4180,completed
9530,rigid,18268,22440,22448,4172,8,4180,completed
9531,rigid,18268,22440,22447,4172,7,4179,completed
9532,rigid,18268,22440,22445,4172,5,4177,completed
9533,rigid,18268,22441,22450,4173,9,4182,completed
9534,rigid,18268,22441,22449,4173,8,4181,completed
9535,rigid,18268,22441,22449,4173,8,4181,completed
9536,rigid,18268,22441,22447,4173,6,4179,completed
9537,rigid,18268,22442,22446,4174,4,4178,completed
9538,rigid,18268,22442,22446,4174,4,4178,completed
9539,rigid,18268,22442,22453,4174,11,4185,completed
9540,rigid,18268,22442,22445,4174,3,4177,completed
9541,rigid,18268,22442,22449,4174,7,4181,completed
9542,rigid,18268,22442,22449,4174,7,4181,completed
9543,rigid,18268,22442,22447,4174,5,4179,completed
9544,rigid,18268,22442,22450,4174,8,4182,completed
9545,rigid,18268,22442,22450,4174,8,4182,completed
9546,rigid,18268,22442,22451,4174,9,4183,completed
9547,rigid,18268,22442,22446,4174,4,4178,completed
9548,rigid,18268,22443,22451,4175,8,4183,completed
9549,rigid,18268,22443,22452,4175,9,4184,completed
9550,rigid,18268,22443,22446,4175,3,4178,completed
9551,rigid,18268,22443,22452,4175,9,4184,completed
9552,rigid,18268,22443,22452,4175,9,4184,completed
9553,rigid,18268,22443,22451,4175,8,4183,completed
9554,rigid,18268,22443,22448,4175,5,4180,completed
9555,rigid,18268,22443,22448,4175,5,4180,completed
9556,rigid,18268,22443,22447,4175,4,4179,completed
9557,rigid,18268,22443,22449,4175,6,4181,completed
9558,rigid,18268,22443,22447,4175,4,4179,completed
9559,rigid,18280,22444,22472,4164,28,4192,completed
9560,rigid,18304,22446,22686,4142,240,4382,completed
9561,rigid,18354,22446,22466,4092,20,4112,completed
9562,rigid,18354,22446,22479,4092,33,4125,completed
9563,rigid,18354,22446,22472,4092,26,4118,completed
9564,rigid,18354,22447,22479,4093,32,4125,completed
9565,rigid,18354,22447,22486,4093,39,4132,completed
9566,rigid,18354,22447,22473,4093,26,4119,completed
9567,rigid,18354,22447,22476,4093,29,4122,completed
9568,rigid,18354,22447,22478,4093,31,4124,completed
9569,rigid,18354,22447,22478,4093,31,4124,completed
9570,rigid,18354,22447,22477,4093,30,4123,completed
9571,rigid,18354,22447,22480,4093,33,4126,completed
9572,rigid,18354,22448,22490,4094,42,4136,completed
9573,rigid,18354,22448,22512,4094,64,4158,completed
9574,rigid,18354,22448,22472,4094,24,4118,completed
9575,rigid,18354,22448,22479,4094,31,4125,completed
9576,rigid,18354,22448,22486,4094,38,4132,completed
9577,rigid,18354,22448,22507,4094,59,4153,completed
9578,rigid,18354,22448,22489,4094,41,4135,completed
9579,rigid,18354,22448,22513,4094,65,4159,completed
9580,rigid,18354,22448,22488,4094,40,4134,completed
9581,rigid,18354,22448,22490,4094,42,4136,completed
9582,rigid,18354,22448,22494,4094,46,4140,completed
9583,rigid,18354,22449,22523,4095,74,4169,completed
9584,rigid,18354,22449,22520,4095,71,4166,completed
9585,rigid,18354,22449,22523,4095,74,4169,completed
9586,rigid,18354,22449,22497,4095,48,4143,completed
9587,rigid,18354,22449,22497,4095,48,4143,completed
9588,rigid,18354,22449,22484,4095,35,4130,completed
9589,rigid,18354,22449,22491,4095,42,4137,completed
9590,rigid,18354,22449,22491,4095,42,4137,completed
9591,rigid,18354,22449,22481,4095,32,4127,completed
9592,rigid,18354,22449,22499,4095,50,4145,completed
9593,rigid,18354,22449,22484,4095,35,4130,completed
9594,rigid,18354,22449,22505,4095,56,4151,completed
9595,rigid,18354,22449,22472,4095,23,4118,completed
9596,rigid,18354,22450,22478,4096,28,4124,completed
9597,rigid,18354,22450,22487,4096,37,4133,completed
9598,rigid,18354,22450,22471,4096,21,4117,completed
9599,rigid,18354,22451,22528,4097,77,4174,completed
9600,rigid,18354,22451,22504,4097,53,4150,completed
9601,rigid,18354,22451,22484,4097,33,4130,completed
9602,rigid,18354,22452,22483,4098,31,4129,completed
9603,rigid,18354,22452,22497,4098,45,4143,completed
9604,rigid,18354,22452,22506,4098,54,4152,completed
9605,rigid,18354,22453,22498,4099,45,4144,completed
9606,rigid,18354,22466,22508,4112,42,4154,completed
9607,rigid,18354,22471,22519,4117,48,4165,completed
9608,rigid,18354,22472,22500,4118,28,4146,completed
9609,rigid,18354,22472,22496,4118,24,4142,completed
9610,rigid,18354,22472,22497,4118,25,4143,completed
9611,rigid,18354,22472,22501,4118,29,4147,completed
9612,rigid,18354,22472,22495,4118,23,4141,completed
9613,rigid,18354,22472,22494,4118,22,4140,completed
9614,rigid,18354,22472,22497,4118,25,4143,completed
9615,rigid,18354,22473,22501,4119,28,4147,completed
9616,rigid,18354,22476,22513,4122,37,4159,completed
9617,rigid,18354,22477,22505,4123,28,4151,completed
9618,rigid,18354,22478,22509,4124,31,4155,completed
9619,rigid,18354,22478,22499,4124,21,4145,completed
9620,rigid,18354,22478,22510,4124,32,4156,completed
9621,rigid,18354,22479,22515,4125,36,4161,completed
9622,rigid,18354,22479,22522,4125,43,4168,completed
9623,rigid,18354,22479,22531,4125,52,4177,completed
9624,rigid,18354,22479,22505,4125,26,4151,completed
9625,rigid,18354,22479,22514,4125,35,4160,completed
9626,rigid,18354,22479,22531,4125,52,4177,completed
9627,rigid,18354,22479,22512,4125,33,4158,completed
9628,rigid,18354,22480,22508,4126,28,4154,completed
9629,rigid,18354,22481,22520,4127,39,4166,completed
9630,rigid,18354,22483,22512,4129,29,4158,completed
9631,rigid,18354,22484,22508,4130,24,4154,completed
9632,rigid,18354,22484,22506,4130,22,4152,completed
9633,rigid,18354,22484,22496,4130,12,4142,completed
9634,rigid,18354,22486,22511,4132,25,4157,completed
9635,rigid,18354,22486,22507,4132,21,4153,completed
9636,rigid,18354,22487,22503,4133,16,4149,completed
9637,rigid,18354,22488,22525,4134,37,4171,completed
9638,rigid,18354,22489,22516,4135,27,4162,completed
9639,rigid,18354,22490,22518,4136,28,4164,completed
9640,rigid,18354,22490,22518,4136,28,4164,completed
9641,rigid,18354,22491,22519,4137,28,4165,completed
9642,rigid,18354,22491,22522,4137,31,4168,completed
9643,rigid,18354,22492,22523,4138,31,4169,completed
9644,rigid,18354,22492,22520,4138,28,4166,completed
9645,rigid,18354,22492,22546,4138,54,4192,completed
9646,rigid,18354,22492,22515,4138,23,4161,completed
9647,rigid,18354,22494,22520,4140,26,4166,completed
9648,rigid,18354,22494,22532,4140,38,4178,completed
9649,rigid,18354,22495,22587,4141,92,4233,completed
9650,rigid,18354,22496,22535,4142,39,4181,completed
9651,rigid,18354,22496,22527,4142,31,4173,completed
9652,rigid,18354,22497,22535,4143,38,4181,completed
9653,rigid,18354,22497,22532,4143,35,4178,completed
9654,rigid,18354,22497,22547,4143,50,4193,completed
9655,rigid,18354,22497,22560,4143,63,4206,completed
9656,rigid,18354,22497,22553,4143,56,4199,completed
9657,rigid,18354,22497,22543,4143,46,4189,completed
9658,rigid,18354,22497,22533,4143,36,4179,completed
9659,rigid,18354,22497,22541,4143,44,4187,completed
9660,rigid,18354,22497,22539,4143,42,4185,completed
9661,rigid,18354,22498,22543,4144,45,4189,completed
9662,rigid,18354,22499,22539,4145,40,4185,completed
9663,rigid,18354,22499,22548,4145,49,4194,completed
9664,rigid,18354,22500,22546,4146,46,4192,completed
9665,rigid,18354,22501,22537,4147,36,4183,completed
9666,rigid,18354,22501,22562,4147,61,4208,completed
9667,rigid,18354,22503,22533,4149,30,4179,completed
9668,rigid,18354,22504,22529,4150,25,4175,completed
9669,rigid,18354,22505,22527,4151,22,4173,completed
9670,rigid,18354,22505,22527,4151,22,4173,completed
9671,rigid,18354,22505,22547,4151,42,4193,completed
9672,rigid,18354,22506,22544,4152,38,4190,completed
9673,rigid,18354,22506,22546,4152,40,4192,completed
9674,rigid,18354,22507,22546,4153,39,4192,completed
9675,rigid,18354,22507,22559,4153,52,4205,completed
9676,rigid,18354,22508,22539,4154,31,4185,completed
9677,rigid,18354,22508,22562,4154,54,4208,completed
9678,rigid,18354,22508,22550,4154,42,4196,completed
9679,rigid,18354,22509,22529,4155,20,4175,completed
9680,rigid,18354,22510,22553,4156,43,4199,completed
9681,rigid,18354,22511,22547,4157,36,4193,completed
9682,rigid,18354,22512,22544,4158,32,4190,completed
9683,rigid,18354,22512,22545,4158,33,4191,completed
9684,rigid,18354,22512,22523,4158,11,4169,completed
9685,rigid,18354,22512,22533,4158,21,4179,completed
9686,rigid,18354,22512,22527,4158,15,4173,completed
9687,rigid,18354,22512,22542,4158,30,4188,completed
9688,rigid,18354,22513,22554,4159,41,4200,completed
9689,rigid,18354,22513,22539,4159,26,4185,completed
9690,rigid,18354,22514,22536,4160,22,4182,completed
9691,rigid,18354,22515,22546,4161,31,4192,completed
9692,rigid,18354,22515,22554,4161,39,4200,completed
9693,rigid,18354,22516,22542,4162,26,4188,completed
9694,rigid,18354,22518,22561,4164,43,4207,completed
9695,rigid,18354,22518,22567,4164,49,4213,completed
9696,rigid,18354,22518,22535,4164,17,4181,completed
9697,rigid,18354,22518,22567,4164,49,4213,completed
9698,rigid,18354,22518,22562,4164,44,4208,completed
9699,rigid,18354,22518,22557,4164,39,4203,completed
9700,rigid,18354,22518,22539,4164,21,4185,completed
9701,rigid,18354,22518,22543,4164,25,4189,completed
9702,rigid,18354,22518,22543,4164,25,4189,completed
9703,rigid,18354,22518,22551,4164,33,4197,completed
9704,rigid,18354,22518,22541,4164,23,4187,completed
9705,rigid,18355,22518,24246,4163,1728,5891,completed
9706,rigid,18364,22518,24246,4154,1728,5882,completed
9707,rigid,18368,22519,24247,4151,1728,5879,completed
9708,rigid,18403,22520,22521,4117,1,4118,completed
9709,rigid,18404,22521,22522,4117,1,4118,completed
9710,rigid,18404,22522,22523,4118,1,4119,completed
9711,rigid,18404,22523,22524,4119,1,4120,completed
9712,rigid,18404,22523,22524,4119,1,4120,completed
9713,rigid,18404,22524,22525,4120,1,4121,completed
9714,rigid,18416,22524,22525,4108,1,4109,completed
9715,rigid,18416,22525,22526,4109,1,4110,completed
9716,rigid,18416,22525,22526,4109,1,4110,completed
9717,rigid,18432,22525,22526,4093,1,4094,completed
9718,rigid,18432,22526,22527,4094,1,4095,completed
9719,rigid,18433,22546,23131,4113,585,4698,completed
9720,rigid,18441,22546,22547,4105,1,4106,completed
9721,rigid,18441,22547,22548,4106,1,4107,completed
9722,rigid,18441,22547,22548,4106,1,4107,completed
9723,rigid,18441,22547,22548,4106,1,4107,completed
9724,rigid,18441,22547,22548,4106,1,4107,completed
9725,rigid,18444,22547,22548,4103,1,4104,completed
9726,rigid,18444,22548,22549,4104,1,4105,completed
9727,rigid,18445,22548,22549,4103,1,4104,completed
9728,rigid,18450,22548,22549,4098,1,4099,completed
9729,rigid,18451,22548,22549,4097,1,4098,completed
9730,rigid,18452,22548,22549,4096,1,4097,completed
9731,rigid,18453,22549,23030,4096,481,4577,completed
9732,rigid,18471,22549,22550,4078,1,4079,completed
9733,rigid,18472,22549,22550,4077,1,4078,completed
9734,rigid,18476,22550,22551,4074,1,4075,completed
9735,rigid,18476,22550,22551,4074,1,4075,completed
9736,rigid,18476,22551,22552,4075,1,4076,completed
9737,rigid,18535,22553,23144,4018,591,4609,completed
9738,rigid,18592,22562,23221,3970,659,4629,completed
9739,rigid,18669,22573,25106,3904,2533,6437,completed
9740,rigid,18680,22613,24546,3933,1933,5866,completed
9741,rigid,18689,22615,23194,3926,579,4505,completed
9742,rigid,18689,22619,22934,3930,315,4245,completed
9743,rigid,18700,22624,22927,3924,303,4227,completed
9744,rigid,18700,22644,23209,3944,565,4509,completed
9745,rigid,18786,22645,24090,3859,1445,5304,completed
9746,rigid,18786,22647,23097,3861,450,4311,completed
9747,rigid,18786,22647,23511,3861,864,4725,completed
9748,rigid,18787,22647,22715,3860,68,3928,completed
9749,rigid,18787,22651,22702,3864,51,3915,completed
9750,rigid,18787,22651,22700,3864,49,3913,completed
9751,rigid,18787,22652,22733,3865,81,3946,completed
9752,rigid,18787,22652,22734,3865,82,3947,completed
9753,rigid,18787,22661,22743,3874,82,3956,completed
9754,rigid,18787,22666,22748,3879,82,3961,completed
9755,rigid,18787,22686,22768,3899,82,3981,completed
9756,rigid,18787,22686,22762,3899,76,3975,completed
9757,rigid,18787,22686,22754,3899,68,3967,completed
9758,rigid,18787,22698,22766,3911,68,3979,completed
9759,rigid,18787,22700,22768,3913,68,3981,completed
9760,rigid,18790,22704,22721,3914,17,3931,completed
9761,rigid,18802,22721,22834,3919,113,4032,completed
9762,rigid,18818,22727,22871,3909,144,4053,completed
9763,rigid,18828,22727,22763,3899,36,3935,completed
9764,rigid,18828,22733,22769,3905,36,3941,completed
9765,rigid,18828,22734,22770,3906,36,3942,completed
9766,rigid,18829,22768,22790,3939,22,3961,completed
9767,rigid,18830,22770,22829,3940,59,3999,completed
9768,rigid,18831,22770,23202,3939,432,4371,completed
9769,rigid,18831,22771,23097,3940,326,4266,completed
9770,rigid,18831,22771,23203,3940,432,4372,completed
9771,rigid,18832,22772,22793,3940,21,3961,completed
9772,rigid,18835,22772,22778,3937,6,3943,completed
9773,rigid,18838,22772,23112,3934,340,4274,completed
9774,rigid,18838,22774,23030,3936,256,4192,completed
9775,rigid,18838,22774,23025,3936,251,4187,completed
9776,rigid,18838,22774,23044,3936,270,4206,completed
9777,rigid,18838,22774,23086,3936,312,4248,completed
9778,rigid,18838,22774,23105,3936,331,4267,completed
9779,rigid,18838,22774,23145,3936,371,4307,completed
9780,rigid,18846,22790,27023,3944,4233,8177,completed
9781,rigid,18864,22790,22798,3926,8,3934,completed
9782,rigid,18873,22793,22803,3920,10,3930,completed
9783,rigid,18873,22793,23174,3920,381,4301,completed
9784,rigid,18874,22796,22812,3922,16,3938,completed
9785,rigid,18890,22796,22832,3906,36,3942,completed
9786,rigid,18890,22796,22832,3906,36,3942,completed
9787,rigid,18897,22796,22798,3899,2,3901,completed
9788,rigid,18904,22797,22806,3893,9,3902,completed
9789,rigid,18904,22798,22847,3894,49,3943,completed
9790,rigid,18904,22798,22852,3894,54,3948,completed
9791,rigid,18904,22799,23022,3895,223,4118,completed
9792,rigid,18904,22802,22803,3898,1,3899,completed
9793,rigid,18904,22802,22808,3898,6,3904,completed
9794,rigid,18904,22802,22817,3898,15,3913,completed
9795,rigid,18904,22802,22853,3898,51,3949,completed
9796,rigid,18904,22803,22830,3899,27,3926,completed
9797,rigid,18904,22803,22816,3899,13,3912,completed
9798,rigid,18904,22803,22840,3899,37,3936,completed
9799,rigid,18904,22803,22882,3899,79,3978,completed
9800,rigid,18904,22803,23703,3899,900,4799,completed
9801,rigid,18904,22803,23169,3899,366,4265,completed
9802,rigid,18904,22803,23133,3899,330,4229,completed
9803,rigid,18904,22803,23703,3899,900,4799,completed
9804,rigid,18906,22803,23955,3897,1152,5049,completed
9805,rigid,18908,22806,24102,3898,1296,5194,completed
9806,rigid,18908,22806,24102,3898,1296,5194,completed
9807,rigid,18918,22812,22813,3894,1,3895,completed
9808,rigid,18929,22812,22813,3883,1,3884,completed
9809,rigid,18952,22812,23906,3860,1094,4954,completed
9810,rigid,18952,22813,23146,3861,333,4194,completed
9811,rigid,18952,22813,24066,3861,1253,5114,completed
9812,rigid,18952,22813,23375,3861,562,4423,completed
9813,rigid,18952,22813,23715,3861,902,4763,completed
9814,rigid,18952,22816,23709,3864,893,4757,completed
9815,rigid,18953,22818,22819,3865,1,3866,completed
9816,rigid,18953,22819,23751,3866,932,4798,completed
9817,rigid,18953,22819,23444,3866,625,4491,completed
9818,rigid,18953,22821,23617,3868,796,4664,completed
9819,rigid,18956,22821,23100,3865,279,4144,completed
9820,rigid,18956,22830,22873,3874,43,3917,completed
9821,rigid,18958,22840,22841,3882,1,3883,completed
9822,rigid,18962,22868,22869,3906,1,3907,completed
9823,rigid,18963,22869,22871,3906,2,3908,completed
9824,rigid,18966,22869,22880,3903,11,3914,completed
9825,rigid,18967,22871,22892,3904,21,3925,completed
9826,rigid,18969,22871,23088,3902,217,4119,completed
9827,rigid,18969,22873,23085,3904,212,4116,completed
9828,rigid,18969,22873,23090,3904,217,4121,completed
9829,rigid,18969,22873,23091,3904,218,4122,completed
9830,rigid,18969,22873,23092,3904,219,4123,completed
9831,rigid,18969,22880,23101,3911,221,4132,completed
9832,rigid,18969,22880,23096,3911,216,4127,completed
9833,rigid,18969,22880,23098,3911,218,4129,completed
9834,rigid,18969,22880,23097,3911,217,4128,completed
9835,rigid,18969,22882,23099,3913,217,4130,completed
9836,rigid,18969,22892,23106,3923,214,4137,completed
9837,rigid,18969,22892,23109,3923,217,4140,completed
9838,rigid,18969,22892,23109,3923,217,4140,completed
9839,rigid,18969,22892,23108,3923,216,4139,completed
9840,rigid,18969,22892,23110,3923,218,4141,completed
9841,rigid,18969,22892,23103,3923,211,4134,completed
9842,rigid,18969,22892,23105,3923,213,4136,completed
9843,rigid,18969,22892,23108,3923,216,4139,completed
9844,rigid,18969,22927,23143,3958,216,4174,completed
9845,rigid,18969,22927,23150,3958,223,4181,completed
9846,rigid,18979,22934,23036,3955,102,4057,completed
9847,rigid,18979,22934,22936,3955,2,3957,completed
9848,rigid,18979,22963,22990,3984,27,4011,completed
9849,rigid,18980,22963,23121,3983,158,4141,completed
9850,rigid,18984,22984,23000,4000,16,4016,completed
9851,rigid,18986,22990,23034,4004,44,4048,completed
9852,rigid,18986,22990,23033,4004,43,4047,completed
9853,rigid,18987,22990,23330,4003,340,4343,completed
9854,rigid,18987,22990,23243,4003,253,4256,completed
9855,rigid,18987,22990,23236,4003,246,4249,completed
9856,rigid,18987,22990,23279,4003,289,4292,completed
9857,rigid,18987,22990,23316,4003,326,4329,completed
9858,rigid,18987,22990,23308,4003,318,4321,completed
9859,rigid,18987,22990,23263,4003,273,4276,completed
9860,rigid,18987,22990,23354,4003,364,4367,completed
9861,rigid,18990,22990,23026,4000,36,4036,completed
9862,rigid,18990,22990,23026,4000,36,4036,completed
9863,rigid,18990,22990,23026,4000,36,4036,completed
9864,rigid,18995,22993,23115,3998,122,4120,completed
9865,rigid,18995,23000,23126,4005,126,4131,completed
9866,rigid,18995,23000,23123,4005,123,4128,completed
9867,rigid,19000,23000,23835,4000,835,4835,completed
9868,rigid,19019,23000,23021,3981,21,4002,completed
9869,rigid,19019,23000,23039,3981,39,4020,completed
9870,rigid,19019,23000,24710,3981,1710,5691,completed
9871,rigid,19028,23000,23003,3972,3,3975,completed
9872,rigid,19040,23000,23001,3960,1,3961,completed
9873,rigid,19042,23000,23001,3958,1,3959,completed
9874,rigid,19042,23001,23226,3959,225,4184,completed
9875,rigid,19044,23001,23007,3957,6,3963,completed
9876,rigid,19052,23003,23005,3951,2,3953,completed
9877,rigid,19062,23003,23005,3941,2,3943,completed
9878,rigid,19063,23021,23027,3958,6,3964,completed
9879,rigid,19063,23027,23029,3964,2,3966,completed
9880,rigid,19063,23029,23032,3966,3,3969,completed
9881,rigid,19063,23032,23035,3969,3,3972,completed
9882,rigid,19063,23033,23035,3970,2,3972,completed
9883,rigid,19063,23035,23039,3972,4,3976,completed
9884,rigid,19064,23035,23071,3971,36,4007,completed
9885,rigid,19064,23035,23071,3971,36,4007,completed
9886,rigid,19064,23035,23071,3971,36,4007,completed
9887,rigid,19064,23035,27114,3971,4079,8050,completed
9888,rigid,19069,23035,23037,3966,2,3968,completed
9889,rigid,19073,23035,24763,3962,1728,5690,completed
9890,rigid,19073,23035,23717,3962,682,4644,completed
9891,rigid,19073,23035,24763,3962,1728,5690,completed
9892,rigid,19075,23035,23036,3960,1,3961,completed
9893,rigid,19079,23035,23036,3956,1,3957,completed
9894,rigid,19081,23035,23036,3954,1,3955,completed
9895,rigid,19085,23035,23147,3950,112,4062,completed
9896,rigid,19087,23035,23037,3948,2,3950,completed
9897,rigid,19087,23035,23636,3948,601,4549,completed
9898,rigid,19088,23036,23641,3948,605,4553,completed
9899,rigid,19101,23036,23038,3935,2,3937,completed
9900,rigid,19121,23036,23154,3915,118,4033,completed
9901,rigid,19122,23036,23397,3914,361,4275,completed
9902,rigid,19122,23037,23537,3915,500,4415,completed
9903,rigid,19122,23038,23586,3916,548,4464,completed
9904,rigid,19166,23039,23045,3873,6,3879,completed
9905,rigid,19169,23039,23055,3870,16,3886,completed
9906,rigid,19169,23055,23075,3886,20,3906,completed
9907,rigid,19171,23058,23070,3887,12,3899,completed
9908,rigid,19172,23058,23066,3886,8,3894,completed
9909,rigid,19181,23058,23076,3877,18,3895,completed
9910,rigid,19181,23066,23081,3885,15,3900,completed
9911,rigid,19183,23066,23086,3883,20,3903,completed
9912,rigid,19184,23070,23083,3886,13,3899,completed
9913,rigid,19190,23070,23165,3880,95,3975,completed
9914,rigid,19191,23070,23230,3879,160,4039,completed
9915,rigid,19201,23073,23074,3872,1,3873,completed
9916,rigid,19203,23074,23075,3871,1,3872,completed
9917,rigid,19248,23074,23124,3826,50,3876,completed
9918,rigid,19252,23075,24569,3823,1494,5317,completed
9919,rigid,19282,23075,23117,3793,42,3835,completed
9920,rigid,19282,23076,23095,3794,19,3813,completed
9921,rigid,19295,23076,23236,3781,160,3941,completed
9922,rigid,19299,23081,24779,3782,1698,5480,completed
9923,rigid,19304,23081,23084,3777,3,3780,completed
9924,rigid,19312,23083,23085,3771,2,3773,completed
9925,rigid,19320,23083,23310,3763,227,3990,completed
9926,rigid,19330,23085,23126,3755,41,3796,completed
9927,rigid,19330,23086,23105,3756,19,3775,completed
9928,rigid,19379,23090,23330,3711,240,3951,completed
9929,rigid,19379,23095,23192,3716,97,3813,completed
9930,rigid,19426,23096,26092,3670,2996,6666,completed
9931,rigid,19428,23098,25818,3670,2720,6390,completed
9932,rigid,19428,23103,25963,3675,2860,6535,completed
9933,rigid,19429,23105,26073,3676,2968,6644,completed
9934,rigid,19431,23108,26458,3677,3350,7027,completed
9935,rigid,19434,23110,25669,3676,2559,6235,completed
9936,rigid,19434,23117,25710,3683,2593,6276,completed
9937,rigid,19434,23121,26011,3687,2890,6577,completed
9938,rigid,19434,23124,25704,3690,2580,6270,completed
9939,rigid,19435,23126,26097,3691,2971,6662,completed
9940,rigid,19435,23131,25282,3696,2151,5847,completed
9941,rigid,19435,23131,24895,3696,1764,5460,completed
9942,rigid,19435,23131,25120,3696,1989,5685,completed
9943,rigid,19435,23131,25457,3696,2326,6022,completed
9944,rigid,19435,23131,25519,3696,2388,6084,completed
9945,rigid,19435,23135,25398,3700,2263,5963,completed
9946,rigid,19462,23135,23146,3673,11,3684,completed
9947,rigid,19462,23135,23146,3673,11,3684,completed
9948,rigid,19594,23140,23205,3546,65,3611,completed
9949,rigid,19650,23140,23589,3490,449,3939,completed
9950,rigid,19650,23140,24156,3490,1016,4506,completed
9951,rigid,19650,23140,24868,3490,1728,5218,completed
9952,rigid,19652,23143,24463,3491,1320,4811,completed
9953,rigid,19652,23144,23982,3492,838,4330,completed
9954,rigid,19652,23144,24574,3492,1430,4922,completed
9955,rigid,19653,23144,24153,3491,1009,4500,completed
9956,rigid,19653,23144,24077,3491,933,4424,completed
9957,rigid,19653,23145,24356,3492,1211,4703,completed
9958,rigid,19653,23146,23655,3493,509,4002,completed
9959,rigid,19653,23147,24511,3494,1364,4858,completed
9960,rigid,19653,23150,24820,3497,1670,5167,completed
9961,rigid,19656,23154,24018,3498,864,4362,completed
9962,rigid,19656,23154,24018,3498,864,4362,completed
9963,rigid,19656,23165,24029,3509,864,4373,completed
9964,rigid,19658,23169,24091,3511,922,4433,completed
9965,rigid,19658,23174,24902,3516,1728,5244,completed
9966,rigid,19658,23174,24775,3516,1601,5117,completed
9967,rigid,19659,23174,23736,3515,562,4077,completed
9968,rigid,19659,23174,24902,3515,1728,5243,completed
9969,rigid,19659,23180,23825,3521,645,4166,completed
9970,rigid,19660,23180,24496,3520,1316,4836,completed
9971,rigid,19660,23180,24322,3520,1142,4662,completed
9972,rigid,19660,23180,24333,3520,1153,4673,completed
9973,rigid,19660,23180,24086,3520,906,4426,completed
9974,rigid,19660,23180,24908,3520,1728,5248,completed
9975,rigid,19660,23180,23926,3520,746,4266,completed
9976,rigid,19665,23192,23225,3527,33,3560,completed
9977,rigid,19669,23192,23245,3523,53,3576,completed
9978,rigid,19669,23192,23245,3523,53,3576,completed
9979,rigid,19669,23192,23242,3523,50,3573,completed
9980,rigid,19669,23192,23319,3523,127,3650,completed
9981,rigid,19669,23192,23361,3523,169,3692,completed
9982,rigid,19669,23192,23347,3523,155,3678,completed
9983,rigid,19669,23192,23494,3523,302,3825,completed
9984,rigid,19669,23194,23486,3525,292,3817,completed
9985,rigid,19669,23194,23482,3525,288,3813,completed
9986,rigid,19672,23194,24455,3522,1261,4783,completed
9987,rigid,19672,23194,23947,3522,753,4275,completed
9988,rigid,19672,23194,24609,3522,1415,4937,completed
9989,rigid,19683,23205,23267,3522,62,3584,completed
9990,rigid,19683,23209,23271,3526,62,3588,completed
9991,rigid,19683,23209,23271,3526,62,3588,completed
9992,rigid,19683,23212,23281,3529,69,3598,completed
9993,rigid,19686,23255,24750,3569,1495,5064,completed
9994,rigid,19689,23271,24604,3582,1333,4915,completed
9995,rigid,19690,23271,23281,3581,10,3591,completed
9996,rigid,19693,23271,26008,3578,2737,6315,completed
9997,rigid,19693,23271,23380,3578,109,3687,completed
9998,rigid,19706,23279,23343,3573,64,3637,completed
9999,rigid,19709,23308,24353,3599,1045,4644,completed
10000,rigid,19715,23308,23317,3593,9,3602,completed
10001,rigid,19716,23310,23312,3594,2,3596,completed
10002,rigid,19717,23310,23311,3593,1,3594,completed
10003,rigid,19719,23310,23322,3591,12,3603,completed
10004,rigid,19719,23311,23327,3592,16,3608,completed
10005,rigid,19722,23311,23321,3589,10,3599,completed
10006,rigid,19723,23311,23321,3588,10,3598,completed
10007,rigid,19732,23311,23313,3579,2,3581,completed
10008,rigid,19733,23312,24503,3579,1191,4770,completed
10009,rigid,19733,23316,24627,3583,1311,4894,completed
10010,rigid,19733,23327,24656,3594,1329,4923,completed
10011,rigid,19733,23327,23329,3594,2,3596,completed
10012,rigid,19734,23327,23329,3593,2,3595,completed
10013,rigid,19735,23327,23759,3592,432,4024,completed
10014,rigid,19744,23410,23422,3666,12,3678,completed
10015,rigid,19746,23422,23445,3676,23,3699,completed
10016,rigid,19746,23422,24678,3676,1256,4932,completed
10017,rigid,19747,23422,23432,3675,10,3685,completed
10018,rigid,19747,23422,23432,3675,10,3685,completed
10019,rigid,19748,23422,24042,3674,620,4294,completed
10020,rigid,19748,23422,26014,3674,2592,6266,completed
10021,rigid,19748,23422,23888,3674,466,4140,completed
10022,rigid,19748,23422,26014,3674,2592,6266,completed
10023,rigid,19748,23422,23955,3674,533,4207,completed
10024,rigid,19748,23422,26014,3674,2592,6266,completed
10025,rigid,19748,23422,26014,3674,2592,6266,completed
10026,rigid,19748,23422,26014,3674,2592,6266,completed
10027,rigid,19748,23422,24301,3674,879,4553,completed
10028,rigid,19748,23422,24692,3674,1270,4944,completed
10029,rigid,19748,23422,24101,3674,679,4353,completed
10030,rigid,19748,23422,23904,3674,482,4156,completed
10031,rigid,19748,23432,25995,3684,2563,6247,completed
10032,rigid,19748,23444,25516,3696,2072,5768,completed
10033,rigid,19748,23445,24935,3697,1490,5187,completed
10034,rigid,19748,23445,25552,3697,2107,5804,completed
10035,rigid,19748,23464,23918,3716,454,4170,completed
10036,rigid,19748,23464,25061,3716,1597,5313,completed
10037,rigid,19748,23464,26056,3716,2592,6308,completed
10038,rigid,19748,23464,25650,3716,2186,5902,completed
10039,rigid,19748,23482,26074,3734,2592,6326,completed
10040,rigid,19748,23494,24295,3746,801,4547,completed
10041,rigid,19748,23500,26092,3752,2592,6344,completed
10042,rigid,19748,23511,23910,3763,399,4162,completed
10043,rigid,19748,23537,26129,3789,2592,6381,completed
10044,rigid,19748,23537,24930,3789,1393,5182,completed
10045,rigid,19748,23539,26131,3791,2592,6383,completed
10046,rigid,19748,23539,23852,3791,313,4104,completed
10047,rigid,19748,23539,23716,3791,177,3968,completed
10048,rigid,19748,23539,23586,3791,47,3838,completed
10049,rigid,19748,23539,23753,3791,214,4005,completed
10050,rigid,19748,23539,25229,3791,1690,5481,completed
10051,rigid,19748,23539,26131,3791,2592,6383,completed
10052,rigid,19748,23539,23703,3791,164,3955,completed
10053,rigid,19748,23539,24022,3791,483,4274,completed
10054,rigid,19748,23539,26131,3791,2592,6383,completed
10055,rigid,19748,23539,26131,3791,2592,6383,completed
10056,rigid,19748,23539,23997,3791,458,4249,completed
10057,rigid,19748,23539,23989,3791,450,4241,completed
10058,rigid,19748,23539,24110,3791,571,4362,completed
10059,rigid,19748,23539,23964,3791,425,4216,completed
10060,rigid,19748,23539,26131,3791,2592,6383,completed
10061,rigid,19748,23539,24375,3791,836,4627,completed
10062,rigid,19748,23539,24641,3791,1102,4893,completed
10063,rigid,19748,23539,24863,3791,1324,5115,completed
10064,rigid,19748,23539,26131,3791,2592,6383,completed
10065,rigid,19748,23539,25860,3791,2321,6112,completed
10066,rigid,19748,23540,26132,3792,2592,6384,completed
10067,rigid,19748,23540,26132,3792,2592,6384,completed
10068,rigid,19748,23540,26132,3792,2592,6384,completed
10069,rigid,19748,23540,26132,3792,2592,6384,completed
10070,rigid,19748,23540,26132,3792,2592,6384,completed
10071,rigid,19748,23540,26132,3792,2592,6384,completed
10072,rigid,19748,23540,24896,3792,1356,5148,completed
10073,rigid,19748,23540,26132,3792,2592,6384,completed
10074,rigid,19748,23540,26132,3792,2592,6384,completed
10075,rigid,19748,23540,23974,3792,434,4226,completed
10076,rigid,19748,23540,26132,3792,2592,6384,completed
10077,rigid,19748,23540,26132,3792,2592,6384,completed
10078,rigid,19748,23540,23792,3792,252,4044,completed
10079,rigid,19748,23540,23967,3792,427,4219,completed
10080,rigid,19748,23540,26132,3792,2592,6384,completed
10081,rigid,19748,23540,24189,3792,649,4441,completed
10082,rigid,19748,23540,26132,3792,2592,6384,completed
10083,rigid,19748,23540,26132,3792,2592,6384,completed
10084,rigid,19748,23540,26132,3792,2592,6384,completed
10085,rigid,19748,23540,26132,3792,2592,6384,completed
10086,rigid,19748,23540,26132,3792,2592,6384,completed
10087,rigid,19748,23572,26164,3824,2592,6416,completed
10088,rigid,19748,23572,24772,3824,1200,5024,completed
10089,rigid,19748,23572,24067,3824,495,4319,completed
10090,rigid,19748,23572,26164,3824,2592,6416,completed
10091,rigid,19748,23572,23975,3824,403,4227,completed
10092,rigid,19748,23572,26164,3824,2592,6416,completed
10093,rigid,19748,23572,26164,3824,2592,6416,completed
10094,rigid,19748,23586,25015,3838,1429,5267,completed
10095,rigid,19748,23586,26169,3838,2583,6421,completed
10096,rigid,19748,23586,26178,3838,2592,6430,completed
10097,rigid,19748,23589,24826,3841,1237,5078,completed
10098,rigid,19748,23610,24945,3862,1335,5197,completed
10099,rigid,19748,23610,24620,3862,1010,4872,completed
10100,rigid,19748,23610,26202,3862,2592,6454,completed
10101,rigid,19748,23610,25653,3862,2043,5905,completed
10102,rigid,19748,23610,24502,3862,892,4754,completed
10103,rigid,19748,23610,25666,3862,2056,5918,completed
10104,rigid,19748,23610,25485,3862,1875,5737,completed
10105,rigid,19748,23617,26209,3869,2592,6461,completed
10106,rigid,19748,23621,24965,3873,1344,5217,completed
10107,rigid,19748,23636,25077,3888,1441,5329,completed
10108,rigid,19749,23641,23795,3892,154,4046,completed
10109,rigid,19749,23647,23885,3898,238,4136,completed
10110,rigid,19749,23647,26239,3898,2592,6490,completed
10111,rigid,19749,23655,26247,3906,2592,6498,completed
10112,rigid,19749,23685,26277,3936,2592,6528,completed
10113,rigid,19749,23685,26277,3936,2592,6528,completed
10114,rigid,19749,23686,26278,3937,2592,6529,completed
10115,rigid,19749,23687,26279,3938,2592,6530,completed
10116,rigid,19749,23687,26279,3938,2592,6530,completed
10117,rigid,19749,23687,24794,3938,1107,5045,completed
10118,rigid,19749,23687,26279,3938,2592,6530,completed
10119,rigid,19749,23687,26279,3938,2592,6530,completed
10120,rigid,19749,23687,26279,3938,2592,6530,completed
10121,rigid,19749,23688,26280,3939,2592,6531,completed
10122,rigid,19749,23688,26280,3939,2592,6531,completed
10123,rigid,19749,23689,24760,3940,1071,5011,completed
10124,rigid,19749,23690,26282,3941,2592,6533,completed
10125,rigid,19750,23691,23812,3941,121,4062,completed
10126,rigid,19752,23692,23702,3940,10,3950,completed
10127,rigid,19752,23702,23720,3950,18,3968,completed
10128,rigid,19752,23703,23718,3951,15,3966,completed
10129,rigid,19753,23709,23729,3956,20,3976,completed
10130,rigid,19753,23716,23741,3963,25,3988,completed
10131,rigid,19753,23718,23721,3965,3,3968,completed
10132,rigid,19753,23720,23936,3967,216,4183,completed
10133,rigid,19753,23721,23733,3968,12,3980,completed
10134,rigid,19754,23729,23776,3975,47,4022,completed
10135,rigid,19754,23733,23762,3979,29,4008,completed
10136,rigid,19754,23736,23776,3982,40,4022,completed
10137,rigid,19754,23741,23757,3987,16,4003,completed
10138,rigid,19754,23753,23836,3999,83,4082,completed
10139,rigid,19755,23757,23773,4002,16,4018,completed
10140,rigid,19760,23757,23761,3997,4,4001,completed
10141,rigid,19760,23757,23766,3997,9,4006,completed
10142,rigid,19760,23757,23760,3997,3,4000,completed
10143,rigid,19760,23757,23760,3997,3,4000,completed
10144,rigid,19760,23757,23760,3997,3,4000,completed
10145,rigid,19760,23759,23765,3999,6,4005,completed
10146,rigid,19760,23759,23768,3999,9,4008,completed
10147,rigid,19760,23759,23767,3999,8,4007,completed
10148,rigid,19760,23759,23762,3999,3,4002,completed
10149,rigid,19760,23759,23769,3999,10,4009,completed
10150,rigid,19760,23759,23769,3999,10,4009,completed
10151,rigid,19760,23759,23761,3999,2,4001,completed
10152,rigid,19760,23759,23766,3999,7,4006,completed
10153,rigid,19760,23759,23761,3999,2,4001,completed
10154,rigid,19760,23759,23766,3999,7,4006,completed
10155,rigid,19760,23759,23761,3999,2,4001,completed
10156,rigid,19760,23759,23765,3999,6,4005,completed
10157,rigid,19760,23759,23762,3999,3,4002,completed
10158,rigid,19760,23759,23762,3999,3,4002,completed
10159,rigid,19760,23759,23761,3999,2,4001,completed
10160,rigid,19760,23759,23769,3999,10,4009,completed
10161,rigid,19760,23759,23762,3999,3,4002,completed
10162,rigid,19760,23759,23762,3999,3,4002,completed
10163,rigid,19760,23759,23769,3999,10,4009,completed
10164,rigid,19760,23759,23762,3999,3,4002,completed
10165,rigid,19760,23759,23762,3999,3,4002,completed
10166,rigid,19760,23760,23762,4000,2,4002,completed
10167,rigid,19760,23760,23763,4000,3,4003,completed
10168,rigid,19760,23760,23770,4000,10,4010,completed
10169,rigid,19760,23761,23769,4001,8,4009,completed
10170,rigid,19760,23761,23764,4001,3,4004,completed
10171,rigid,19760,23761,23769,4001,8,4009,completed
10172,rigid,19760,23761,23764,4001,3,4004,completed
10173,rigid,19760,23761,23771,4001,10,4011,completed
10174,rigid,19760,23761,23768,4001,7,4008,completed
10175,rigid,19760,23762,23768,4002,6,4008,completed
10176,rigid,19760,23762,23764,4002,2,4004,completed
10177,rigid,19760,23762,23769,4002,7,4009,completed
10178,rigid,19760,23762,23769,4002,7,4009,completed
10179,rigid,19760,23762,23765,4002,3,4005,completed
10180,rigid,19760,23762,23764,4002,2,4004,completed
10181,rigid,19760,23762,23769,4002,7,4009,completed
10182,rigid,19760,23762,23765,4002,3,4005,completed
10183,rigid,19760,23762,23769,4002,7,4009,completed
10184,rigid,19760,23762,23764,4002,2,4004,completed
10185,rigid,19760,23762,23769,4002,7,4009,completed
10186,rigid,19760,23762,23764,4002,2,4004,completed
10187,rigid,19760,23762,23764,4002,2,4004,completed
10188,rigid,19760,23762,23770,4002,8,4010,completed
10189,rigid,19760,23762,23769,4002,7,4009,completed
10190,rigid,19760,23762,23769,4002,7,4009,completed
10191,rigid,19760,23762,23769,4002,7,4009,completed
10192,rigid,19760,23762,23765,4002,3,4005,completed
10193,rigid,19760,23762,23768,4002,6,4008,completed
10194,rigid,19760,23762,23770,4002,8,4010,completed
10195,rigid,19760,23762,23764,4002,2,4004,completed
10196,rigid,19760,23762,23768,4002,6,4008,completed
10197,rigid,19760,23762,23769,4002,7,4009,completed
10198,rigid,19766,23799,24096,4033,297,4330,completed
10199,rigid,19766,23947,24066,4181,119,4300,completed
10200,rigid,19766,24016,24248,4250,232,4482,completed
10201,rigid,19767,24066,24201,4299,135,4434,completed
10202,rigid,19769,24066,24110,4297,44,4341,completed
10203,rigid,19772,24066,24069,4294,3,4297,completed
10204,rigid,19789,24066,24068,4277,2,4279,completed
10205,rigid,19792,24066,24068,4274,2,4276,completed
10206,rigid,19796,24066,24099,4270,33,4303,completed
10207,rigid,19803,24066,25048,4263,982,5245,completed
10208,rigid,19809,24067,24081,4258,14,4272,completed
10209,rigid,19809,24068,24082,4259,14,4273,completed
10210,rigid,19809,24069,24070,4260,1,4261,completed
10211,rigid,19809,24069,24070,4260,1,4261,completed
10212,rigid,19822,24081,46894,4259,22813,27072,completed
10213,rigid,19824,24081,24122,4257,41,4298,completed
10214,rigid,19830,24081,24088,4251,7,4258,completed
10215,rigid,19831,24082,24119,4251,37,4288,completed
10216,rigid,19831,24086,24104,4255,18,4273,completed
10217,rigid,19831,24091,24110,4260,19,4279,completed
10218,rigid,19831,24096,24114,4265,18,4283,completed
10219,rigid,19831,24096,24133,4265,37,4302,completed
10220,rigid,19831,24096,24125,4265,29,4294,completed
10221,rigid,19831,24096,24131,4265,35,4300,completed
10222,rigid,19831,24096,24209,4265,113,4378,completed
10223,rigid,19831,24096,24149,4265,53,4318,completed
10224,rigid,19831,24096,24109,4265,13,4278,completed
10225,rigid,19831,24096,24112,4265,16,4281,completed
10226,rigid,19831,24096,24105,4265,9,4274,completed
10227,rigid,19831,24102,24134,4271,32,4303,completed
10228,rigid,19831,24104,24173,4273,69,4342,completed
10229,rigid,19831,24105,24136,4274,31,4305,completed
10230,rigid,19835,24105,25833,4270,1728,5998,completed
10231,rigid,19835,24109,25837,4274,1728,6002,completed
10232,rigid,19835,24109,25837,4274,1728,6002,completed
10233,rigid,19838,24109,24149,4271,40,4311,completed
10234,rigid,19844,24110,24112,4266,2,4268,completed
10235,rigid,19845,24110,24229,4265,119,4384,completed
10236,rigid,19850,24110,24197,4260,87,4347,completed
10237,rigid,19850,24110,24197,4260,87,4347,completed
10238,rigid,19850,24110,24202,4260,92,4352,completed
10239,rigid,19850,24110,24178,4260,68,4328,completed
10240,rigid,19850,24110,24187,4260,77,4337,completed
10241,rigid,19850,24110,24194,4260,84,4344,completed
10242,rigid,19850,24110,24165,4260,55,4315,completed
10243,rigid,19850,24110,24213,4260,103,4363,completed
10244,rigid,19850,24110,24264,4260,154,4414,completed
10245,rigid,19850,24112,24255,4262,143,4405,completed
10246,rigid,19850,24112,24236,4262,124,4386,completed
10247,rigid,19850,24112,24280,4262,168,4430,completed
10248,rigid,19850,24114,24315,4264,201,4465,completed
10249,rigid,19850,24114,24361,4264,247,4511,completed
10250,rigid,19850,24119,24241,4269,122,4391,completed
10251,rigid,19850,24119,24296,4269,177,4446,completed
10252,rigid,19850,24119,24244,4269,125,4394,completed
10253,rigid,19850,24125,24255,4275,130,4405,completed
10254,rigid,19850,24125,24242,4275,117,4392,completed
10255,rigid,19850,24131,24318,4281,187,4468,completed
10256,rigid,19850,24131,24313,4281,182,4463,completed
10257,rigid,19850,24133,24212,4283,79,4362,completed
10258,rigid,19850,24133,24226,4283,93,4376,completed
10259,rigid,19850,24134,24223,4284,89,4373,completed
10260,rigid,19850,24134,24244,4284,110,4394,completed
10261,rigid,19850,24134,24266,4284,132,4416,completed
10262,rigid,19850,24136,24381,4286,245,4531,completed
10263,rigid,19850,24136,24243,4286,107,4393,completed
10264,rigid,19850,24149,24321,4299,172,4471,completed
10265,rigid,19850,24149,24331,4299,182,4481,completed
10266,rigid,19850,24153,24327,4303,174,4477,completed
10267,rigid,19850,24156,24337,4306,181,4487,completed
10268,rigid,19850,24156,24290,4306,134,4440,completed
10269,rigid,19850,24165,24293,4315,128,4443,completed
10270,rigid,19851,24173,24265,4322,92,4414,completed
10271,rigid,19851,24173,24253,4322,80,4402,completed
10272,rigid,19851,24178,24259,4327,81,4408,completed
10273,rigid,19851,24187,24270,4336,83,4419,completed
10274,rigid,19851,24189,24251,4338,62,4400,completed
10275,rigid,19851,24194,24265,4343,71,4414,completed
10276,rigid,19851,24197,24275,4346,78,4424,completed
10277,rigid,19851,24197,24247,4346,50,4396,completed
10278,rigid,19851,24201,24273,4350,72,4422,completed
10279,rigid,19851,24201,24286,4350,85,4435,completed
10280,rigid,19851,24201,24344,4350,143,4493,completed
10281,rigid,19851,24201,24332,4350,131,4481,completed
10282,rigid,19851,24201,24316,4350,115,4465,completed
10283,rigid,19851,24201,24357,4350,156,4506,completed
10284,rigid,19851,24201,24387,4350,186,4536,completed
10285,rigid,19851,24201,24424,4350,223,4573,completed
10286,rigid,19851,24201,24312,4350,111,4461,completed
10287,rigid,19851,24201,24365,4350,164,4514,completed
10288,rigid,19851,24201,24316,4350,115,4465,completed
10289,rigid,19851,24201,24322,4350,121,4471,completed
10290,rigid,19851,24201,24308,4350,107,4457,completed
10291,rigid,19851,24201,24372,4350,171,4521,completed
10292,rigid,19851,24201,24369,4350,168,4518,completed
10293,rigid,19851,24201,24302,4350,101,4451,completed
10294,rigid,19851,24201,24282,4350,81,4431,completed
10295,rigid,19851,24201,24298,4350,97,4447,completed
10296,rigid,19851,24201,24321,4350,120,4470,completed
10297,rigid,19851,24201,24423,4350,222,4572,completed
10298,rigid,19851,24202,24361,4351,159,4510,completed
10299,rigid,19851,24209,24377,4358,168,4526,completed
10300,rigid,19851,24209,24370,4358,161,4519,completed
10301,rigid,19851,24212,24378,4361,166,4527,completed
10302,rigid,19851,24213,24336,4362,123,4485,completed
10303,rigid,19851,24223,24340,4372,117,4489,completed
10304,rigid,19862,24229,24240,4367,11,4378,completed
10305,rigid,19863,24240,24254,4377,14,4391,completed
10306,rigid,19863,24241,24259,4378,18,4396,completed
10307,rigid,19863,24243,24245,4380,2,4382,completed
10308,rigid,19863,24244,24262,4381,18,4399,completed
10309,rigid,19863,24247,24252,4384,5,4389,completed
10310,rigid,19863,24248,24255,4385,7,4392,completed
10311,rigid,19863,24248,24249,4385,1,4386,completed
10312,rigid,19863,24248,24249,4385,1,4386,completed
10313,rigid,19863,24248,24250,4385,2,4387,completed
10314,rigid,19863,24249,24250,4386,1,4387,completed
10315,rigid,19863,24249,24250,4386,1,4387,completed
10316,rigid,19863,24250,24251,4387,1,4388,completed
10317,rigid,19863,24250,24251,4387,1,4388,completed
10318,rigid,19863,24250,24251,4387,1,4388,completed
10319,rigid,19863,24251,24255,4388,4,4392,completed
10320,rigid,19863,24251,24257,4388,6,4394,completed
10321,rigid,19863,24251,24257,4388,6,4394,completed
10322,rigid,19863,24252,24258,4389,6,4395,completed
10323,rigid,19863,24253,24263,4390,10,4400,completed
10324,rigid,19863,24255,24266,4392,11,4403,completed
10325,rigid,19863,24255,24257,4392,2,4394,completed
10326,rigid,19863,24255,24257,4392,2,4394,completed
10327,rigid,19863,24257,24259,4394,2,4396,completed
10328,rigid,19863,24257,24259,4394,2,4396,completed
10329,rigid,19863,24257,24259,4394,2,4396,completed
10330,rigid,19863,24257,24259,4394,2,4396,completed
10331,rigid,19863,24258,24259,4395,1,4396,completed
10332,rigid,19863,24259,24260,4396,1,4397,completed
10333,rigid,19863,24259,24261,4396,2,4398,completed
10334,rigid,19863,24259,24261,4396,2,4398,completed
10335,rigid,19863,24259,24275,4396,16,4412,completed
10336,rigid,19863,24259,24275,4396,16,4412,completed
10337,rigid,19863,24260,24263,4397,3,4400,completed
10338,rigid,19863,24261,24264,4398,3,4401,completed
10339,rigid,19863,24261,24263,4398,2,4400,completed
10340,rigid,19863,24262,24264,4399,2,4401,completed
10341,rigid,19863,24263,24269,4400,6,4406,completed
10342,rigid,19863,24263,24269,4400,6,4406,completed
10343,rigid,19863,24263,24265,4400,2,4402,completed
10344,rigid,19863,24264,24266,4401,2,4403,completed
10345,rigid,19863,24264,24265,4401,1,4402,completed
10346,rigid,19863,24265,24266,4402,1,4403,completed
10347,rigid,19863,24265,24266,4402,1,4403,completed
10348,rigid,19863,24265,24266,4402,1,4403,completed
10349,rigid,19863,24266,24273,4403,7,4410,completed
10350,rigid,19863,24266,24273,4403,7,4410,completed
10351,rigid,19863,24266,24273,4403,7,4410,completed
10352,rigid,19863,24266,24274,4403,8,4411,completed
10353,rigid,19863,24266,24271,4403,5,4408,completed
10354,rigid,19863,24269,24275,4406,6,4412,completed
10355,rigid,19864,24269,24281,4405,12,4417,completed
10356,rigid,19864,24269,24312,4405,43,4448,completed
10357,rigid,19864,24270,24277,4406,7,4413,completed
10358,rigid,19864,24271,24278,4407,7,4414,completed
10359,rigid,19864,24271,24278,4407,7,4414,completed
10360,rigid,19864,24271,24278,4407,7,4414,completed
10361,rigid,19864,24271,24278,4407,7,4414,completed
10362,rigid,19864,24273,24280,4409,7,4416,completed
10363,rigid,19864,24273,24280,4409,7,4416,completed
10364,rigid,19864,24273,24280,4409,7,4416,completed
10365,rigid,19864,24273,24280,4409,7,4416,completed
10366,rigid,19864,24273,24280,4409,7,4416,completed
10367,rigid,19864,24273,24280,4409,7,4416,completed
10368,rigid,19864,24273,24280,4409,7,4416,completed
10369,rigid,19864,24273,24280,4409,7,4416,completed
10370,rigid,19864,24273,24280,4409,7,4416,completed
10371,rigid,19864,24273,24280,4409,7,4416,completed
10372,rigid,19864,24273,24280,4409,7,4416,completed
10373,rigid,19864,24273,24287,4409,14,4423,completed
10374,rigid,19864,24274,24291,4410,17,4427,completed
10375,rigid,19864,24274,24294,4410,20,4430,completed
10376,rigid,19865,24275,24290,4410,15,4425,completed
10377,rigid,19865,24275,24307,4410,32,4442,completed
10378,rigid,19865,24275,24284,4410,9,4419,completed
10379,rigid,19869,24275,24723,4406,448,4854,completed
10380,rigid,19877,24275,24363,4398,88,4486,completed
10381,rigid,19878,24275,24282,4397,7,4404,completed
10382,rigid,19887,24277,24305,4390,28,4418,completed
10383,rigid,19891,24278,24308,4387,30,4417,completed
10384,rigid,19894,24278,24776,4384,498,4882,completed
10385,rigid,19894,24278,24914,4384,636,5020,completed
10386,rigid,19894,24278,25897,4384,1619,6003,completed
10387,rigid,19895,24280,25329,4385,1049,5434,completed
10388,rigid,19895,24280,25656,4385,1376,5761,completed
10389,rigid,19895,24280,25036,4385,756,5141,completed
10390,rigid,19903,24280,24938,4377,658,5035,completed
10391,rigid,19905,24280,26566,4375,2286,6661,completed
10392,rigid,19905,24280,26584,4375,2304,6679,completed
10393,rigid,19905,24280,25593,4375,1313,5688,completed
10394,rigid,19905,24280,26163,4375,1883,6258,completed
10395,rigid,19905,24280,25804,4375,1524,5899,completed
10396,rigid,19905,24281,25250,4376,969,5345,completed
10397,rigid,19905,24281,25738,4376,1457,5833,completed
10398,rigid,19905,24282,25412,4377,1130,5507,completed
10399,rigid,19905,24286,25056,4381,770,5151,completed
10400,rigid,19905,24287,25076,4382,789,5171,completed
10401,rigid,19905,24287,25471,4382,1184,5566,completed
10402,rigid,19905,24290,26143,4385,1853,6238,completed
10403,rigid,19905,24290,26186,4385,1896,6281,completed
10404,rigid,19905,24290,26246,4385,1956,6341,completed
10405,rigid,19905,24291,24787,4386,496,4882,completed
10406,rigid,19905,24291,25472,4386,1181,5567,completed
10407,rigid,19905,24293,26483,4388,2190,6578,completed
10408,rigid,19905,24294,26399,4389,2105,6494,completed
10409,rigid,19905,24294,25569,4389,1275,5664,completed
10410,rigid,19905,24295,26174,4390,1879,6269,completed
10411,rigid,19905,24298,25870,4393,1572,5965,completed
10412,rigid,19905,24301,25823,4396,1522,5918,completed
10413,rigid,19905,24302,25506,4397,1204,5601,completed
10414,rigid,19905,24305,25823,4400,1518,5918,completed
10415,rigid,19937,24305,24306,4368,1,4369,completed
10416,rigid,19941,24305,24307,4364,2,4366,completed
10417,rigid,19956,24307,25223,4351,916,5267,completed
10418,rigid,19957,24307,24351,4350,44,4394,completed
10419,rigid,19961,24308,25214,4347,906,5253,completed
10420,rigid,19961,24308,24353,4347,45,4392,completed
10421,rigid,19965,24312,25663,4347,1351,5698,completed
10422,rigid,19966,24312,24313,4346,1,4347,completed
10423,rigid,19967,24316,25646,4349,1330,5679,completed
10424,rigid,19971,24316,24361,4345,45,4390,completed
10425,rigid,19971,24316,25349,4345,1033,5378,completed
10426,rigid,19973,24318,25351,4345,1033,5378,completed
10427,rigid,19976,24318,25790,4342,1472,5814,completed
10428,rigid,19976,24321,25793,4345,1472,5817,completed
10429,rigid,20002,24321,24331,4319,10,4329,completed
10430,rigid,20007,24321,24332,4314,11,4325,completed
10431,rigid,20012,24321,24322,4309,1,4310,completed
10432,rigid,20016,24321,24331,4305,10,4315,completed
10433,rigid,20018,24321,24322,4303,1,4304,completed
10434,rigid,20027,24321,24322,4294,1,4295,completed
10435,rigid,20084,24322,24368,4238,46,4284,completed
10436,rigid,20099,24333,24334,4234,1,4235,completed
10437,rigid,20099,24334,24335,4235,1,4236,completed
10438,rigid,20099,24335,24336,4236,1,4237,completed
10439,rigid,20099,24336,24337,4237,1,4238,completed
10440,rigid,20099,24337,24338,4238,1,4239,completed
10441,rigid,20099,24338,24339,4239,1,4240,completed
10442,rigid,20099,24339,24340,4240,1,4241,completed
10443,rigid,20099,24340,24341,4241,1,4242,completed
10444,rigid,20099,24341,24342,4242,1,4243,completed
10445,rigid,20099,24342,24343,4243,1,4244,completed
10446,rigid,20099,24343,24344,4244,1,4245,completed
10447,rigid,20099,24344,24345,4245,1,4246,completed
10448,rigid,20099,24344,24345,4245,1,4246,completed
10449,rigid,20099,24345,24346,4246,1,4247,completed
10450,rigid,20099,24345,24346,4246,1,4247,completed
10451,rigid,20099,24346,24347,4247,1,4248,completed
10452,rigid,20099,24346,24347,4247,1,4248,completed
10453,rigid,20117,24347,24348,4230,1,4231,completed
10454,rigid,20117,24347,25906,4230,1559,5789,completed
10455,rigid,20152,24347,24349,4195,2,4197,completed
10456,rigid,20152,24349,25111,4197,762,4959,completed
10457,rigid,20155,24356,24370,4201,14,4215,completed
10458,rigid,20155,24363,24365,4208,2,4210,completed
10459,rigid,20159,24368,24572,4209,204,4413,completed
10460,rigid,20159,24370,25013,4211,643,4854,completed
10461,rigid,20164,24377,24392,4213,15,4228,completed
10462,rigid,20181,24392,24466,4211,74,4285,completed
10463,rigid,20183,24421,24451,4238,30,4268,completed
10464,rigid,20208,24421,24445,4213,24,4237,completed
10465,rigid,20208,24445,24469,4237,24,4261,completed
10466,rigid,20208,24451,24475,4243,24,4267,completed
10467,rigid,20208,24463,24487,4255,24,4279,completed
10468,rigid,20208,24466,24491,4258,25,4283,completed
10469,rigid,20208,24469,24493,4261,24,4285,completed
10470,rigid,20208,24475,24500,4267,25,4292,completed
10471,rigid,20208,24487,24511,4279,24,4303,completed
10472,rigid,20208,24491,24515,4283,24,4307,completed
10473,rigid,20208,24493,24518,4285,25,4310,completed
10474,rigid,20208,24500,24525,4292,25,4317,completed
10475,rigid,20208,24511,24535,4303,24,4327,completed
10476,rigid,20208,24511,24536,4303,25,4328,completed
10477,rigid,20208,24515,24540,4307,25,4332,completed
10478,rigid,20208,24518,24543,4310,25,4335,completed
10479,rigid,20208,24525,24550,4317,25,4342,completed
10480,rigid,20208,24535,24560,4327,25,4352,completed
10481,rigid,20208,24536,24561,4328,25,4353,completed
10482,rigid,20208,24540,24565,4332,25,4357,completed
10483,rigid,20208,24543,24568,4335,25,4360,completed
10484,rigid,20208,24546,24571,4338,25,4363,completed
10485,rigid,20208,24550,24574,4342,24,4366,completed
10486,rigid,20208,24560,24584,4352,24,4376,completed
10487,rigid,20208,24561,24586,4353,25,4378,completed
10488,rigid,20208,24565,24589,4357,24,4381,completed
10489,rigid,20208,24568,24593,4360,25,4385,completed
10490,rigid,20208,24571,24596,4363,25,4388,completed
10491,rigid,20208,24572,24596,4364,24,4388,completed
10492,rigid,20208,24572,24597,4364,25,4389,completed
10493,rigid,20208,24574,24599,4366,25,4391,completed
10494,rigid,20208,24584,24609,4376,25,4401,completed
10495,rigid,20208,24586,24611,4378,25,4403,completed
10496,rigid,20208,24589,24613,4381,24,4405,completed
10497,rigid,20208,24593,24618,4385,25,4410,completed
10498,rigid,20208,24596,24620,4388,24,4412,completed
10499,rigid,20208,24596,24620,4388,24,4412,completed
10500,rigid,20252,24597,24681,4345,84,4429,completed
10501,rigid,20252,24599,24652,4347,53,4400,completed
10502,rigid,20252,24604,24650,4352,46,4398,completed
10503,rigid,20252,24609,24640,4357,31,4388,completed
10504,rigid,20253,24611,24745,4358,134,4492,completed
10505,rigid,20254,24613,24670,4359,57,4416,completed
10506,rigid,20256,24618,24854,4362,236,4598,completed
10507,rigid,20256,24620,24692,4364,72,4436,completed
10508,rigid,20257,24620,24856,4363,236,4599,completed
10509,rigid,20257,24620,24737,4363,117,4480,completed
10510,rigid,20257,24640,25624,4383,984,5367,completed
10511,rigid,20257,24650,25074,4393,424,4817,completed
10512,rigid,20258,24652,24725,4394,73,4467,completed
10513,rigid,20258,24656,24699,4398,43,4441,completed
10514,rigid,20258,24656,24781,4398,125,4523,completed
10515,rigid,20258,24663,24762,4405,99,4504,completed
10516,rigid,20258,24670,24907,4412,237,4649,completed
10517,rigid,20259,24678,24794,4419,116,4535,completed
10518,rigid,20259,24681,25679,4422,998,5420,completed
10519,rigid,20259,24686,25106,4427,420,4847,completed
10520,rigid,20260,24692,24761,4432,69,4501,completed
10521,rigid,20261,24699,24744,4438,45,4483,completed
10522,rigid,20261,24710,24834,4449,124,4573,completed
10523,rigid,20261,24723,24818,4462,95,4557,completed
10524,rigid,20273,24725,24961,4452,236,4688,completed
10525,rigid,20273,24737,24852,4464,115,4579,completed
10526,rigid,20273,24744,25740,4471,996,5467,completed
10527,rigid,20273,24745,25168,4472,423,4895,completed
10528,rigid,20273,24750,24823,4477,73,4550,completed
10529,rigid,20273,24750,24795,4477,45,4522,completed
10530,rigid,20274,24750,24876,4476,126,4602,completed
10531,rigid,20274,24750,24848,4476,98,4574,completed
10532,rigid,20274,24750,24983,4476,233,4709,completed
10533,rigid,20275,24750,24865,4475,115,4590,completed
10534,rigid,20275,24761,25743,4486,982,5468,completed
10535,rigid,20276,24762,25181,4486,419,4905,completed
10536,rigid,20277,24772,24842,4495,70,4565,completed
10537,rigid,20277,24779,24904,4502,125,4627,completed
10538,rigid,20278,24781,24875,4503,94,4597,completed
10539,rigid,20279,24794,24879,4515,85,4600,completed
10540,rigid,20279,24795,24846,4516,51,4567,completed
10541,rigid,20280,24818,25055,4538,237,4775,completed
10542,rigid,20280,24820,24953,4540,133,4673,completed
10543,rigid,20281,24823,24869,4542,46,4588,completed
10544,rigid,20281,24834,24908,4553,74,4627,completed
10545,rigid,20282,24842,24900,4560,58,4618,completed
10546,rigid,20544,24846,25504,4302,658,4960,completed
10547,rigid,20558,24856,24982,4298,126,4424,completed
10548,rigid,20588,24865,24886,4277,21,4298,completed
10549,rigid,20588,24868,24897,4280,29,4309,completed
10550,rigid,20588,24869,25715,4281,846,5127,completed
10551,rigid,20589,24875,25739,4286,864,5150,completed
10552,rigid,20590,24876,24896,4286,20,4306,completed
10553,rigid,20591,24879,24897,4288,18,4306,completed
10554,rigid,20615,24879,24900,4264,21,4285,completed
10555,rigid,20615,24879,24927,4264,48,4312,completed
10556,rigid,20618,24879,24911,4261,32,4293,completed
10557,rigid,20618,24879,24929,4261,50,4311,completed
10558,rigid,20618,24879,24910,4261,31,4292,completed
10559,rigid,20639,24880,24884,4241,4,4245,completed
10560,rigid,20647,24880,24887,4233,7,4240,completed
10561,rigid,20705,24896,24900,4191,4,4195,completed
10562,rigid,20710,24896,25044,4186,148,4334,completed
10563,rigid,20710,24896,25033,4186,137,4323,completed
10564,rigid,20710,24897,25141,4187,244,4431,completed
10565,rigid,20710,24897,25089,4187,192,4379,completed
10566,rigid,20710,24897,25078,4187,181,4368,completed
10567,rigid,20710,24897,25136,4187,239,4426,completed
10568,rigid,20710,24897,25053,4187,156,4343,completed
10569,rigid,20710,24897,25031,4187,134,4321,completed
10570,rigid,20710,24897,24990,4187,93,4280,completed
10571,rigid,20710,24897,24995,4187,98,4285,completed
10572,rigid,20710,24897,24965,4187,68,4255,completed
10573,rigid,20710,24900,24995,4190,95,4285,completed
10574,rigid,20710,24900,25242,4190,342,4532,completed
10575,rigid,20710,24900,25237,4190,337,4527,completed
10576,rigid,20710,24900,25073,4190,173,4363,completed
10577,rigid,20710,24900,25133,4190,233,4423,completed
10578,rigid,20710,24900,25087,4190,187,4377,completed
10579,rigid,20710,24900,25076,4190,176,4366,completed
10580,rigid,20710,24900,25078,4190,178,4368,completed
10581,rigid,20710,24900,25010,4190,110,4300,completed
10582,rigid,20710,24900,25216,4190,316,4506,completed
10583,rigid,20710,24900,25199,4190,299,4489,completed
10584,rigid,20710,24900,25016,4190,116,4306,completed
10585,rigid,20710,24900,25002,4190,102,4292,completed
10586,rigid,20710,24900,25064,4190,164,4354,completed
10587,rigid,20710,24900,25042,4190,142,4332,completed
10588,rigid,20710,24900,25204,4190,304,4494,completed
10589,rigid,20710,24900,25029,4190,129,4319,completed
10590,rigid,20710,24900,25126,4190,226,4416,completed
10591,rigid,20710,24900,25134,4190,234,4424,completed
10592,rigid,20710,24900,25171,4190,271,4461,completed
10593,rigid,20710,24900,25221,4190,321,4511,completed
10594,rigid,20710,24900,25130,4190,230,4420,completed
10595,rigid,20710,24902,25092,4192,190,4382,completed
10596,rigid,20712,24902,25045,4190,143,4333,completed
10597,rigid,20712,24902,25075,4190,173,4363,completed
10598,rigid,20712,24902,25133,4190,231,4421,completed
10599,rigid,20712,24902,25098,4190,196,4386,completed
10600,rigid,20712,24902,25078,4190,176,4366,completed
10601,rigid,20712,24902,25128,4190,226,4416,completed
10602,rigid,20712,24904,25062,4192,158,4350,completed
10603,rigid,20712,24904,25029,4192,125,4317,completed
10604,rigid,20712,24904,25258,4192,354,4546,completed
10605,rigid,20712,24904,25226,4192,322,4514,completed
10606,rigid,20712,24907,25093,4195,186,4381,completed
10607,rigid,20712,24907,25121,4195,214,4409,completed
10608,rigid,20712,24907,25004,4195,97,4292,completed
10609,rigid,20712,24907,25006,4195,99,4294,completed
10610,rigid,20712,24907,24977,4195,70,4265,completed
10611,rigid,20712,24908,25004,4196,96,4292,completed
10612,rigid,20712,24908,25101,4196,193,4389,completed
10613,rigid,20712,24908,25082,4196,174,4370,completed
10614,rigid,20712,24908,25070,4196,162,4358,completed
10615,rigid,20712,24908,25025,4196,117,4313,completed
10616,rigid,20712,24914,25219,4202,305,4507,completed
10617,rigid,20712,24930,25241,4218,311,4529,completed
10618,rigid,20712,24930,25047,4218,117,4335,completed
10619,rigid,20712,24935,25044,4223,109,4332,completed
10620,rigid,20712,24938,25094,4226,156,4382,completed
10621,rigid,20712,24938,25068,4226,130,4356,completed
10622,rigid,20712,24938,25214,4226,276,4502,completed
10623,rigid,20712,24938,25080,4226,142,4368,completed
10624,rigid,20712,24945,25164,4233,219,4452,completed
10625,rigid,20712,24953,25174,4241,221,4462,completed
10626,rigid,20712,24953,25224,4241,271,4512,completed
10627,rigid,20712,24953,25304,4241,351,4592,completed
10628,rigid,20712,24953,25186,4241,233,4474,completed
10629,rigid,20712,24953,25124,4241,171,4412,completed
10630,rigid,20713,24961,25054,4248,93,4341,completed
10631,rigid,20713,24961,25070,4248,109,4357,completed
10632,rigid,20713,24961,25125,4248,164,4412,completed
10633,rigid,20713,24961,25115,4248,154,4402,completed
10634,rigid,20713,24965,25096,4252,131,4383,completed
10635,rigid,20713,24965,25061,4252,96,4348,completed
10636,rigid,20713,24977,25076,4264,99,4363,completed
10637,rigid,20713,24982,25055,4269,73,4342,completed
10638,rigid,20713,24982,25064,4269,82,4351,completed
10639,rigid,20713,24982,25077,4269,95,4364,completed
10640,rigid,20713,24982,25043,4269,61,4330,completed
10641,rigid,20713,24982,25074,4269,92,4361,completed
10642,rigid,20713,24982,25077,4269,95,4364,completed
10643,rigid,20713,24982,25157,4269,175,4444,completed
10644,rigid,20713,24982,25202,4269,220,4489,completed
10645,rigid,20713,24982,25248,4269,266,4535,completed
10646,rigid,20713,24982,25112,4269,130,4399,completed
10647,rigid,20713,24982,25170,4269,188,4457,completed
10648,rigid,20713,24982,25114,4269,132,4401,completed
10649,rigid,20713,24982,25120,4269,138,4407,completed
10650,rigid,20713,24982,25111,4269,129,4398,completed
10651,rigid,20713,24982,25181,4269,199,4468,completed
10652,rigid,20713,24982,25175,4269,193,4462,completed
10653,rigid,20713,24982,25083,4269,101,4370,completed
10654,rigid,20713,24983,25103,4270,120,4390,completed
10655,rigid,20713,24983,25116,4270,133,4403,completed
10656,rigid,20713,24983,25238,4270,255,4525,completed
10657,rigid,20713,24983,25097,4270,114,4384,completed
10658,rigid,20713,24983,25160,4270,177,4447,completed
10659,rigid,20713,24990,25187,4277,197,4474,completed
10660,rigid,20713,24995,25195,4282,200,4482,completed
10661,rigid,20713,24995,25192,4282,197,4479,completed
10662,rigid,20713,25002,25146,4289,144,4433,completed
10663,rigid,20713,25004,25138,4291,134,4425,completed
10664,rigid,20713,25004,25091,4291,87,4378,completed
10665,rigid,20713,25006,25107,4293,101,4394,completed
10666,rigid,20713,25010,25161,4297,151,4448,completed
10667,rigid,20713,25013,25102,4300,89,4389,completed
10668,rigid,20713,25013,25103,4300,90,4390,completed
10669,rigid,20713,25013,25081,4300,68,4368,completed
10670,rigid,20713,25013,25092,4300,79,4379,completed
10671,rigid,20713,25013,25100,4300,87,4387,completed
10672,rigid,20713,25013,25070,4300,57,4357,completed
10673,rigid,20713,25013,25097,4300,84,4384,completed
10674,rigid,20713,25015,25109,4302,94,4396,completed
10675,rigid,20713,25016,25104,4303,88,4391,completed
10676,rigid,20713,25025,25164,4312,139,4451,completed
10677,rigid,20713,25029,25148,4316,119,4435,completed
10678,rigid,20713,25029,25192,4316,163,4479,completed
10679,rigid,20713,25031,25231,4318,200,4518,completed
10680,rigid,20713,25033,25275,4320,242,4562,completed
10681,rigid,20713,25036,25154,4323,118,4441,completed
10682,rigid,20713,25042,25217,4329,175,4504,completed
10683,rigid,20713,25043,25165,4330,122,4452,completed
10684,rigid,20713,25044,25175,4331,131,4462,completed
10685,rigid,20713,25044,25164,4331,120,4451,completed
10686,rigid,20713,25045,25227,4332,182,4514,completed
10687,rigid,20713,25047,25224,4334,177,4511,completed
10688,rigid,20713,25048,25158,4335,110,4445,completed
10689,rigid,20713,25052,25174,4339,122,4461,completed
10690,rigid,20713,25052,25284,4339,232,4571,completed
10691,rigid,20713,25052,25158,4339,106,4445,completed
10692,rigid,20713,25052,25214,4339,162,4501,completed
10693,rigid,20713,25052,25232,4339,180,4519,completed
10694,rigid,20713,25052,25229,4339,177,4516,completed
10695,rigid,20713,25052,25230,4339,178,4517,completed
10696,rigid,20713,25053,25185,4340,132,4472,completed
10697,rigid,20713,25054,25180,4341,126,4467,completed
10698,rigid,20716,25055,25167,4339,112,4451,completed
10699,rigid,20720,25055,25091,4335,36,4371,completed
10700,rigid,20721,25055,25091,4334,36,4370,completed
10701,rigid,20725,25074,25256,4349,182,4531,completed
10702,rigid,20745,25074,26802,4329,1728,6057,completed
10703,rigid,20749,25077,25091,4328,14,4342,completed
10704,rigid,20750,25078,25093,4328,15,4343,completed
10705,rigid,20750,25082,25097,4332,15,4347,completed
10706,rigid,20750,25091,25104,4341,13,4354,completed
10707,rigid,20755,25091,26521,4336,1430,5766,completed
10708,rigid,20759,25097,25108,4338,11,4349,completed
10709,rigid,20829,25101,29146,4272,4045,8317,completed
10710,rigid,20851,25103,25146,4252,43,4295,completed
10711,rigid,20852,25104,25127,4252,23,4275,completed
10712,rigid,20852,25104,25128,4252,24,4276,completed
10713,rigid,20852,25104,25127,4252,23,4275,completed
10714,rigid,20852,25106,25126,4254,20,4274,completed
10715,rigid,20852,25106,25127,4254,21,4275,completed
10716,rigid,20852,25106,25130,4254,24,4278,completed
10717,rigid,20852,25106,25128,4254,22,4276,completed
10718,rigid,20852,25108,25129,4256,21,4277,completed
10719,rigid,20852,25108,25131,4256,23,4279,completed
10720,rigid,20852,25108,25132,4256,24,4280,completed
10721,rigid,20852,25108,25124,4256,16,4272,completed
10722,rigid,20852,25108,25122,4256,14,4270,completed
10723,rigid,20852,25108,25120,4256,12,4268,completed
10724,rigid,20852,25108,25118,4256,10,4266,completed
10725,rigid,20852,25108,25119,4256,11,4267,completed
10726,rigid,20901,25109,25715,4208,606,4814,completed
10727,rigid,20901,25111,25719,4210,608,4818,completed
10728,rigid,20961,25111,25543,4150,432,4582,completed
10729,rigid,20964,25122,26546,4158,1424,5582,completed
10730,rigid,20964,25125,25844,4161,719,4880,completed
10731,rigid,20996,25127,25979,4131,852,4983,completed
10732,rigid,20998,25127,25981,4129,854,4983,completed
10733,rigid,21001,25128,26393,4127,1265,5392,completed
10734,rigid,21002,25128,26392,4126,1264,5390,completed
10735,rigid,21004,25130,26858,4126,1728,5854,completed
10736,rigid,21005,25130,26858,4125,1728,5853,completed
10737,rigid,21007,25130,26858,4123,1728,5851,completed
10738,rigid,21015,25130,25139,4115,9,4124,completed
10739,rigid,21015,25130,25139,4115,9,4124,completed
10740,rigid,21015,25130,25134,4115,4,4119,completed
10741,rigid,21015,25130,25137,4115,7,4122,completed
10742,rigid,21015,25130,25134,4115,4,4119,completed
10743,rigid,21015,25130,25134,4115,4,4119,completed
10744,rigid,21023,25132,25956,4109,824,4933,completed
10745,rigid,21048,25160,25166,4112,6,4118,completed
10746,rigid,21052,25164,25404,4112,240,4352,completed
10747,rigid,21064,25166,25168,4102,2,4104,completed
10748,rigid,21064,25166,25168,4102,2,4104,completed
10749,rigid,21064,25166,25169,4102,3,4105,completed
10750,rigid,21064,25168,25171,4104,3,4107,completed
10751,rigid,21125,25168,27173,4043,2005,6048,completed
10752,rigid,21169,25168,25786,3999,618,4617,completed
10753,rigid,21435,25168,25600,3733,432,4165,completed
10754,rigid,21447,25169,25991,3722,822,4544,completed
10755,rigid,21448,25169,25991,3721,822,4543,completed
10756,rigid,21450,25169,26466,3719,1297,5016,completed
10757,rigid,21450,25169,26897,3719,1728,5447,completed
10758,rigid,21450,25171,27130,3721,1959,5680,completed
10759,rigid,21453,25171,25382,3718,211,3929,completed
10760,rigid,21479,25171,25964,3692,793,4485,completed
10761,rigid,21480,25171,25962,3691,791,4482,completed
10762,rigid,21484,25171,26873,3687,1702,5389,completed
10763,rigid,21510,25174,25340,3664,166,3830,completed
10764,rigid,21510,25175,25341,3665,166,3831,completed
10765,rigid,21510,25181,25347,3671,166,3837,completed
10766,rigid,21510,25181,25347,3671,166,3837,completed
10767,rigid,21510,25181,25347,3671,166,3837,completed
10768,rigid,21510,25186,25352,3676,166,3842,completed
10769,rigid,21510,25192,25358,3682,166,3848,completed
10770,rigid,21510,25199,25365,3689,166,3855,completed
10771,rigid,21510,25204,25370,3694,166,3860,completed
10772,rigid,21510,25214,25379,3704,165,3869,completed
10773,rigid,21510,25214,25379,3704,165,3869,completed
10774,rigid,21510,25216,25381,3706,165,3871,completed
10775,rigid,21510,25221,25387,3711,166,3877,completed
10776,rigid,21510,25223,25388,3713,165,3878,completed
10777,rigid,21510,25224,25389,3714,165,3879,completed
10778,rigid,21510,25226,25391,3716,165,3881,completed
10779,rigid,21544,25230,26099,3686,869,4555,completed
10780,rigid,21545,25256,26123,3711,867,4578,completed
10781,rigid,21553,25256,25311,3703,55,3758,completed
10782,rigid,21554,25256,25299,3702,43,3745,completed
10783,rigid,21611,25256,25841,3645,585,4230,completed
10784,rigid,21617,25256,25946,3639,690,4329,completed
10785,rigid,21665,25256,25259,3591,3,3594,completed
10786,rigid,21665,25256,25259,3591,3,3594,completed
10787,rigid,21665,25256,25259,3591,3,3594,completed
10788,rigid,21668,25256,25258,3588,2,3590,completed
10789,rigid,21668,25256,25258,3588,2,3590,completed
10790,rigid,21668,25256,25258,3588,2,3590,completed
10791,rigid,21678,25256,25381,3578,125,3703,completed
10792,rigid,21685,25256,25466,3571,210,3781,completed
10793,rigid,21695,25282,48076,3587,22794,26381,completed
10794,rigid,21736,25282,25285,3546,3,3549,completed
10795,rigid,21745,25304,26710,3559,1406,4965,completed
10796,rigid,21746,25365,25607,3619,242,3861,completed
10797,rigid,21747,25388,25534,3641,146,3787,completed
10798,rigid,21747,25466,25729,3719,263,3982,completed
10799,rigid,21747,25534,25627,3787,93,3880,completed
10800,rigid,21748,25534,26973,3786,1439,5225,completed
10801,rigid,21758,25534,26360,3776,826,4602,completed
10802,rigid,21758,25534,26400,3776,866,4642,completed
10803,rigid,21758,25552,26369,3794,817,4611,completed
10804,rigid,21758,25591,26627,3833,1036,4869,completed
10805,rigid,21758,25607,27122,3849,1515,5364,completed
10806,rigid,21758,25607,26904,3849,1297,5146,completed
10807,rigid,21758,25607,26911,3849,1304,5153,completed
10808,rigid,21758,25607,26435,3849,828,4677,completed
10809,rigid,21758,25607,27350,3849,1743,5592,completed
10810,rigid,21758,25624,26724,3866,1100,4966,completed
10811,rigid,21758,25627,27142,3869,1515,5384,completed
10812,rigid,21758,25627,26718,3869,1091,4960,completed
10813,rigid,21758,25627,26566,3869,939,4808,completed
10814,rigid,21758,25627,26496,3869,869,4738,completed
10815,rigid,21758,25646,26955,3888,1309,5197,completed
10816,rigid,21758,25653,27062,3895,1409,5304,completed
10817,rigid,21772,25729,26593,3957,864,4821,completed
10818,rigid,21776,25729,25789,3953,60,4013,completed
10819,rigid,21819,25729,26443,3910,714,4624,completed
10820,rigid,21820,25729,26443,3909,714,4623,completed
10821,rigid,21820,25729,25742,3909,13,3922,completed
10822,rigid,21821,25734,27088,3913,1354,5267,completed
10823,rigid,21821,25739,26452,3918,713,4631,completed
10824,rigid,21821,25742,35699,3921,9957,13878,completed
10825,rigid,21822,25743,26455,3921,712,4633,completed
10826,rigid,21824,25837,27340,4013,1503,5516,completed
10827,rigid,21826,25841,25842,4015,1,4016,completed
10828,rigid,21837,25841,25844,4004,3,4007,completed
10829,rigid,21842,25841,25842,3999,1,4000,completed
10830,rigid,21848,25842,27163,3994,1321,5315,completed
10831,rigid,21848,25844,25850,3996,6,4002,completed
10832,rigid,21848,25844,25851,3996,7,4003,completed
10833,rigid,21848,25844,25852,3996,8,4004,completed
10834,rigid,21848,25844,25845,3996,1,3997,completed
10835,rigid,21848,25845,25846,3997,1,3998,completed
10836,rigid,21848,25846,25847,3998,1,3999,completed
10837,rigid,21849,25852,27150,4003,1298,5301,completed
10838,rigid,21850,25860,25871,4010,11,4021,completed
10839,rigid,21853,25892,27209,4039,1317,5356,completed
10840,rigid,21853,25892,25894,4039,2,4041,completed
10841,rigid,21853,25892,25894,4039,2,4041,completed
10842,rigid,21853,25892,25894,4039,2,4041,completed
10843,rigid,21855,25892,25894,4037,2,4039,completed
10844,rigid,21855,25892,25894,4037,2,4039,completed
10845,rigid,21856,25892,25895,4036,3,4039,completed
10846,rigid,21859,25892,25893,4033,1,4034,completed
10847,rigid,21859,25892,25893,4033,1,4034,completed
10848,rigid,21859,25892,25893,4033,1,4034,completed
10849,rigid,21862,25893,25904,4031,11,4042,completed
10850,rigid,21875,25895,25905,4020,10,4030,completed
10851,rigid,21878,25897,25913,4019,16,4035,completed
10852,rigid,21892,25904,25916,4012,12,4024,completed
10853,rigid,21901,25905,26147,4004,242,4246,completed
10854,rigid,21919,25991,26348,4072,357,4429,completed
10855,rigid,21926,25995,26007,4069,12,4081,completed
10856,rigid,21957,26007,26018,4050,11,4061,completed
10857,rigid,21990,26011,48888,4021,22877,26898,completed
10858,rigid,22019,26014,26505,3995,491,4486,completed
10859,rigid,22180,26018,34740,3838,8722,12560,completed
10860,rigid,22241,26056,26880,3815,824,4639,completed
10861,rigid,22241,26073,26894,3832,821,4653,completed
10862,rigid,22241,26073,26800,3832,727,4559,completed
10863,rigid,22242,26073,27478,3831,1405,5236,completed
10864,rigid,22242,26073,27373,3831,1300,5131,completed
10865,rigid,22242,26074,27448,3832,1374,5206,completed
10866,rigid,22253,26092,26664,3839,572,4411,completed
10867,rigid,22253,26092,26794,3839,702,4541,completed
10868,rigid,22253,26092,26966,3839,874,4713,completed
10869,rigid,22253,26092,27168,3839,1076,4915,completed
10870,rigid,22253,26092,27021,3839,929,4768,completed
10871,rigid,22253,26097,27825,3844,1728,5572,completed
10872,rigid,22254,26097,27438,3843,1341,5184,completed
10873,rigid,22254,26097,27353,3843,1256,5099,completed
10874,rigid,22254,26097,27560,3843,1463,5306,completed
10875,rigid,22254,26099,26946,3845,847,4692,completed
10876,rigid,22254,26099,26717,3845,618,4463,completed
10877,rigid,22254,26099,27088,3845,989,4834,completed
10878,rigid,22254,26099,26947,3845,848,4693,completed
10879,rigid,22254,26123,27241,3869,1118,4987,completed
10880,rigid,22254,26123,27294,3869,1171,5040,completed
10881,rigid,22255,26123,27122,3868,999,4867,completed
10882,rigid,22255,26123,26520,3868,397,4265,completed
10883,rigid,22255,26123,27216,3868,1093,4961,completed
10884,rigid,22255,26123,26728,3868,605,4473,completed
10885,rigid,22255,26123,27028,3868,905,4773,completed
10886,rigid,22255,26123,26960,3868,837,4705,completed
10887,rigid,22256,26129,26791,3873,662,4535,completed
10888,rigid,22256,26131,26851,3875,720,4595,completed
10889,rigid,22256,26131,27012,3875,881,4756,completed
10890,rigid,22257,26131,26709,3874,578,4452,completed
10891,rigid,22257,26131,27050,3874,919,4793,completed
10892,rigid,22257,26131,26679,3874,548,4422,completed
10893,rigid,22257,26131,27356,3874,1225,5099,completed
10894,rigid,22257,26132,26779,3875,647,4522,completed
10895,rigid,22257,26132,27372,3875,1240,5115,completed
10896,rigid,22258,26132,26601,3874,469,4343,completed
10897,rigid,22258,26132,26524,3874,392,4266,completed
10898,rigid,22258,26132,26468,3874,336,4210,completed
10899,rigid,22258,26132,27339,3874,1207,5081,completed
10900,rigid,22258,26132,27371,3874,1239,5113,completed
10901,rigid,22258,26132,27099,3874,967,4841,completed
10902,rigid,22259,26132,27290,3873,1158,5031,completed
10903,rigid,22259,26132,27322,3873,1190,5063,completed
10904,rigid,22259,26132,26691,3873,559,4432,completed
10905,rigid,22259,26132,28724,3873,2592,6465,completed
10906,rigid,22259,26132,28724,3873,2592,6465,completed
10907,rigid,22259,26132,28724,3873,2592,6465,completed
10908,rigid,22259,26132,28724,3873,2592,6465,completed
10909,rigid,22259,26132,28724,3873,2592,6465,completed
10910,rigid,22259,26143,26440,3884,297,4181,completed
10911,rigid,22259,26147,28739,3888,2592,6480,completed
10912,rigid,22259,26147,28739,3888,2592,6480,completed
10913,rigid,22259,26163,28755,3904,2592,6496,completed
10914,rigid,22259,26164,28756,3905,2592,6497,completed
10915,rigid,22259,26164,26757,3905,593,4498,completed
10916,rigid,22265,26164,26166,3899,2,3901,completed
10917,rigid,22266,26169,27897,3903,1728,5631,completed
10918,rigid,22267,26186,27914,3919,1728,5647,completed
10919,rigid,22268,26202,26634,3934,432,4366,completed
10920,rigid,22269,26209,26211,3940,2,3942,completed
10921,rigid,22269,26211,27939,3942,1728,5670,completed
10922,rigid,22270,26247,26307,3977,60,4037,completed
10923,rigid,22271,26278,28006,4007,1728,5735,completed
10924,rigid,22272,26279,26280,4007,1,4008,completed
10925,rigid,22273,26279,28007,4006,1728,5734,completed
10926,rigid,22273,26279,28007,4006,1728,5734,completed
10927,rigid,22274,26279,26298,4005,19,4024,completed
10928,rigid,22276,26279,26330,4003,51,4054,completed
10929,rigid,22276,26280,26312,4004,32,4036,completed
10930,rigid,22276,26280,26309,4004,29,4033,completed
10931,rigid,22277,26280,28008,4003,1728,5731,completed
10932,rigid,22277,26282,28010,4005,1728,5733,completed
10933,rigid,22277,26298,28026,4021,1728,5749,completed
10934,rigid,22278,26298,26406,4020,108,4128,completed
10935,rigid,22278,26307,26415,4029,108,4137,completed
10936,rigid,22278,26307,26415,4029,108,4137,completed
10937,rigid,22278,26307,26308,4029,1,4030,completed
10938,rigid,22279,26308,28036,4029,1728,5757,completed
10939,rigid,22279,26309,28037,4030,1728,5758,completed
10940,rigid,22279,26312,28040,4033,1728,5761,completed
10941,rigid,22284,26330,26331,4046,1,4047,completed
10942,rigid,22286,26331,26359,4045,28,4073,completed
10943,rigid,22289,26348,27445,4059,1097,5156,completed
10944,rigid,22289,26348,27644,4059,1296,5355,completed
10945,rigid,22290,26348,28076,4058,1728,5786,completed
10946,rigid,22290,26348,28076,4058,1728,5786,completed
10947,rigid,22290,26348,28076,4058,1728,5786,completed
10948,rigid,22299,26348,26364,4049,16,4065,completed
10949,rigid,22300,26348,28076,4048,1728,5776,completed
10950,rigid,22300,26348,28076,4048,1728,5776,completed
10951,rigid,22300,26348,28076,4048,1728,5776,completed
10952,rigid,22302,26348,28076,4046,1728,5774,completed
10953,rigid,22302,26348,28076,4046,1728,5774,completed
10954,rigid,22302,26348,28076,4046,1728,5774,completed
10955,rigid,22304,26348,26350,4044,2,4046,completed
10956,rigid,22307,26348,26376,4041,28,4069,completed
10957,rigid,22308,26348,26350,4040,2,4042,completed
10958,rigid,22318,26348,26406,4030,58,4088,completed
10959,rigid,22321,26348,26413,4027,65,4092,completed
10960,rigid,22322,26348,26405,4026,57,4083,completed
10961,rigid,22322,26348,26397,4026,49,4075,completed
10962,rigid,22327,26348,26419,4021,71,4092,completed
10963,rigid,22327,26348,26349,4021,1,4022,completed
10964,rigid,22328,26348,26406,4020,58,4078,completed
10965,rigid,22328,26348,26406,4020,58,4078,completed
10966,rigid,22328,26348,26383,4020,35,4055,completed
10967,rigid,22328,26349,26454,4021,105,4126,completed
10968,rigid,22328,26359,26393,4031,34,4065,completed
10969,rigid,22328,26360,26394,4032,34,4066,completed
10970,rigid,22328,26360,26395,4032,35,4067,completed
10971,rigid,22328,26364,26422,4036,58,4094,completed
10972,rigid,22328,26369,26403,4041,34,4075,completed
10973,rigid,22328,26369,26403,4041,34,4075,completed
10974,rigid,22328,26376,26434,4048,58,4106,completed
10975,rigid,22328,26376,26457,4048,81,4129,completed
10976,rigid,22328,26383,26417,4055,34,4089,completed
10977,rigid,22328,26392,26427,4064,35,4099,completed
10978,rigid,22328,26393,26451,4065,58,4123,completed
10979,rigid,22329,26393,26426,4064,33,4097,completed
10980,rigid,22330,26393,26394,4063,1,4064,completed
10981,rigid,22330,26393,26395,4063,2,4065,completed
10982,rigid,22330,26393,26394,4063,1,4064,completed
10983,rigid,22330,26394,26395,4064,1,4065,completed
10984,rigid,22330,26394,26395,4064,1,4065,completed
10985,rigid,22330,26394,26395,4064,1,4065,completed
10986,rigid,22330,26394,26395,4064,1,4065,completed
10987,rigid,22330,26395,26396,4065,1,4066,completed
10988,rigid,22330,26395,26396,4065,1,4066,completed
10989,rigid,22330,26395,26396,4065,1,4066,completed
10990,rigid,22330,26395,26396,4065,1,4066,completed
10991,rigid,22330,26395,26396,4065,1,4066,completed
10992,rigid,22330,26395,26396,4065,1,4066,completed
10993,rigid,22330,26396,26397,4066,1,4067,completed
10994,rigid,22330,26396,26397,4066,1,4067,completed
10995,rigid,22330,26396,26397,4066,1,4067,completed
10996,rigid,22330,26396,26397,4066,1,4067,completed
10997,rigid,22330,26396,26397,4066,1,4067,completed
10998,rigid,22330,26396,26397,4066,1,4067,completed
10999,rigid,22330,26397,26398,4067,1,4068,completed
11000,rigid,22330,26397,26398,4067,1,4068,completed
11001,rigid,22330,26397,26398,4067,1,4068,completed
11002,rigid,22330,26397,26398,4067,1,4068,completed
11003,rigid,22330,26397,26398,4067,1,4068,completed
11004,rigid,22330,26397,26398,4067,1,4068,completed
11005,rigid,22330,26398,26399,4068,1,4069,completed
11006,rigid,22330,26398,26399,4068,1,4069,completed
11007,rigid,22330,26398,26399,4068,1,4069,completed
11008,rigid,22330,26398,26399,4068,1,4069,completed
11009,rigid,22330,26398,26399,4068,1,4069,completed
11010,rigid,22330,26398,26399,4068,1,4069,completed
11011,rigid,22330,26399,26400,4069,1,4070,completed
11012,rigid,22330,26399,26400,4069,1,4070,completed
11013,rigid,22330,26399,26400,4069,1,4070,completed
11014,rigid,22330,26399,26400,4069,1,4070,completed
11015,rigid,22330,26399,26400,4069,1,4070,completed
11016,rigid,22330,26399,26400,4069,1,4070,completed
11017,rigid,22331,26400,28091,4069,1691,5760,completed
11018,rigid,22332,26400,26403,4068,3,4071,completed
11019,rigid,22334,26400,26402,4066,2,4068,completed
11020,rigid,22337,26400,26469,4063,69,4132,completed
11021,rigid,22338,26403,26432,4065,29,4094,completed
11022,rigid,22349,26435,26436,4086,1,4087,completed
11023,rigid,22353,26435,26436,4082,1,4083,completed
11024,rigid,22354,26436,26441,4082,5,4087,completed
11025,rigid,22355,26436,26437,4081,1,4082,completed
11026,rigid,22356,26436,26441,4080,5,4085,completed
11027,rigid,22356,26436,26441,4080,5,4085,completed
11028,rigid,22356,26436,26444,4080,8,4088,completed
11029,rigid,22356,26436,26441,4080,5,4085,completed
11030,rigid,22356,26436,26441,4080,5,4085,completed
11031,rigid,22356,26436,26441,4080,5,4085,completed
11032,rigid,22356,26436,26441,4080,5,4085,completed
11033,rigid,22356,26436,26441,4080,5,4085,completed
11034,rigid,22356,26436,26441,4080,5,4085,completed
11035,rigid,22356,26436,26441,4080,5,4085,completed
11036,rigid,22356,26436,26441,4080,5,4085,completed
11037,rigid,22356,26436,26441,4080,5,4085,completed
11038,rigid,22356,26436,26441,4080,5,4085,completed
11039,rigid,22356,26436,26441,4080,5,4085,completed
11040,rigid,22356,26436,26441,4080,5,4085,completed
11041,rigid,22356,26436,26441,4080,5,4085,completed
11042,rigid,22356,26436,26441,4080,5,4085,completed
11043,rigid,22356,26436,26441,4080,5,4085,completed
11044,rigid,22356,26436,26441,4080,5,4085,completed
11045,rigid,22356,26436,26441,4080,5,4085,completed
11046,rigid,22356,26436,26441,4080,5,4085,completed
11047,rigid,22356,26436,26441,4080,5,4085,completed
11048,rigid,22356,26436,26441,4080,5,4085,completed
11049,rigid,22356,26436,26441,4080,5,4085,completed
11050,rigid,22356,26436,26441,4080,5,4085,completed
11051,rigid,22356,26436,26441,4080,5,4085,completed
11052,rigid,22356,26436,26441,4080,5,4085,completed
11053,rigid,22356,26436,26441,4080,5,4085,completed
11054,rigid,22356,26436,26441,4080,5,4085,completed
11055,rigid,22356,26440,26445,4084,5,4089,completed
11056,rigid,22356,26441,26446,4085,5,4090,completed
11057,rigid,22356,26441,26446,4085,5,4090,completed
11058,rigid,22356,26441,26446,4085,5,4090,completed
11059,rigid,22356,26441,26446,4085,5,4090,completed
11060,rigid,22356,26441,26446,4085,5,4090,completed
11061,rigid,22356,26441,26446,4085,5,4090,completed
11062,rigid,22358,26441,26443,4083,2,4085,completed
11063,rigid,22362,26441,26449,4079,8,4087,completed
11064,rigid,22363,26441,26444,4078,3,4081,completed
11065,rigid,22363,26441,26469,4078,28,4106,completed
11066,rigid,22363,26441,26469,4078,28,4106,completed
11067,rigid,22363,26441,26973,4078,532,4610,completed
11068,rigid,22364,26441,26448,4077,7,4084,completed
11069,rigid,22365,26441,26443,4076,2,4078,completed
11070,rigid,22367,26441,26476,4074,35,4109,completed
11071,rigid,22371,26441,26504,4070,63,4133,completed
11072,rigid,22372,26441,26478,4069,37,4106,completed
11073,rigid,22375,26452,26453,4077,1,4078,completed
11074,rigid,22377,26453,26454,4076,1,4077,completed
11075,rigid,22378,26454,26455,4076,1,4077,completed
11076,rigid,22378,26454,26456,4076,2,4078,completed
11077,rigid,22385,26455,27221,4070,766,4836,completed
11078,rigid,22389,26455,27672,4066,1217,5283,completed
11079,rigid,22413,26455,26477,4042,22,4064,completed
11080,rigid,22413,26455,26477,4042,22,4064,completed
11081,rigid,22413,26455,26477,4042,22,4064,completed
11082,rigid,22413,26457,28184,4044,1727,5771,completed
11083,rigid,22413,26458,28186,4045,1728,5773,completed
11084,rigid,22413,26466,28114,4053,1648,5701,completed
11085,rigid,22426,26469,26553,4043,84,4127,completed
11086,rigid,22426,26469,26553,4043,84,4127,completed
11087,rigid,22426,26469,26569,4043,100,4143,completed
11088,rigid,22428,26477,26510,4049,33,4082,completed
11089,rigid,22431,26504,26530,4073,26,4099,completed
11090,rigid,22432,26530,28677,4098,2147,6245,completed
11091,rigid,22433,26546,28714,4113,2168,6281,completed
11092,rigid,22452,26546,26574,4094,28,4122,completed
11093,rigid,22452,26553,26582,4101,29,4130,completed
11094,rigid,22452,26553,26581,4101,28,4129,completed
11095,rigid,22454,26553,26574,4099,21,4120,completed
11096,rigid,22454,26566,28272,4112,1706,5818,completed
11097,rigid,22462,26566,26572,4104,6,4110,completed
11098,rigid,22462,26569,26575,4107,6,4113,completed
11099,rigid,22462,26572,26578,4110,6,4116,completed
11100,rigid,22462,26574,26580,4112,6,4118,completed
11101,rigid,22462,26575,26576,4113,1,4114,completed
11102,rigid,22462,26576,26577,4114,1,4115,completed
11103,rigid,22467,26577,26604,4110,27,4137,completed
11104,rigid,22478,26577,26618,4099,41,4140,completed
11105,rigid,22478,26577,26620,4099,43,4142,completed
11106,rigid,22478,26577,26590,4099,13,4112,completed
11107,rigid,22478,26577,26593,4099,16,4115,completed
11108,rigid,22478,26577,26594,4099,17,4116,completed
11109,rigid,22478,26577,26608,4099,31,4130,completed
11110,rigid,22478,26577,26590,4099,13,4112,completed
11111,rigid,22478,26577,26590,4099,13,4112,completed
11112,rigid,22478,26577,26593,4099,16,4115,completed
11113,rigid,22483,26578,26591,4095,13,4108,completed
11114,rigid,22486,26578,26580,4092,2,4094,completed
11115,rigid,22497,26580,26680,4083,100,4183,completed
11116,rigid,22497,26581,26682,4084,101,4185,completed
11117,rigid,22497,26582,26683,4085,101,4186,completed
11118,rigid,22507,26584,26586,4077,2,4079,completed
11119,rigid,22510,26586,26603,4076,17,4093,completed
11120,rigid,22523,26591,27455,4068,864,4932,completed
11121,rigid,22523,26593,27124,4070,531,4601,completed
11122,rigid,22524,26593,27129,4069,536,4605,completed
11123,rigid,22524,26593,27199,4069,606,4675,completed
11124,rigid,22524,26593,27185,4069,592,4661,completed
11125,rigid,22524,26593,26731,4069,138,4207,completed
11126,rigid,22524,26593,27064,4069,471,4540,completed
11127,rigid,22524,26593,27192,4069,599,4668,completed
11128,rigid,22524,26593,26722,4069,129,4198,completed
11129,rigid,22524,26593,27053,4069,460,4529,completed
11130,rigid,22524,26593,27046,4069,453,4522,completed
11131,rigid,22524,26593,27236,4069,643,4712,completed
11132,rigid,22524,26593,27194,4069,601,4670,completed
11133,rigid,22524,26593,27116,4069,523,4592,completed
11134,rigid,22525,26593,27142,4068,549,4617,completed
11135,rigid,22525,26593,27180,4068,587,4655,completed
11136,rigid,22525,26593,27316,4068,723,4791,completed
11137,rigid,22525,26593,27120,4068,527,4595,completed
11138,rigid,22525,26593,27209,4068,616,4684,completed
11139,rigid,22525,26593,27119,4068,526,4594,completed
11140,rigid,22525,26593,27202,4068,609,4677,completed
11141,rigid,22525,26593,27199,4068,606,4674,completed
11142,rigid,22525,26593,26698,4068,105,4173,completed
11143,rigid,22525,26593,27241,4068,648,4716,completed
11144,rigid,22525,26593,27195,4068,602,4670,completed
11145,rigid,22525,26593,27140,4068,547,4615,completed
11146,rigid,22525,26593,27330,4068,737,4805,completed
11147,rigid,22525,26593,27324,4068,731,4799,completed
11148,rigid,22525,26593,27381,4068,788,4856,completed
11149,rigid,22525,26593,27334,4068,741,4809,completed
11150,rigid,22525,26593,26708,4068,115,4183,completed
11151,rigid,22525,26593,27341,4068,748,4816,completed
11152,rigid,22525,26593,27191,4068,598,4666,completed
11153,rigid,22525,26601,27187,4076,586,4662,completed
11154,rigid,22525,26603,27230,4078,627,4705,completed
11155,rigid,22525,26603,27407,4078,804,4882,completed
11156,rigid,22525,26603,27283,4078,680,4758,completed
11157,rigid,22525,26603,27385,4078,782,4860,completed
11158,rigid,22535,26603,26654,4068,51,4119,completed
11159,rigid,22537,26604,29938,4067,3334,7401,completed
11160,rigid,22537,26627,29956,4090,3329,7419,completed
11161,rigid,22540,26634,26635,4094,1,4095,completed
11162,rigid,22543,26635,26637,4092,2,4094,completed
11163,rigid,22547,26637,26638,4090,1,4091,completed
11164,rigid,22589,26638,26644,4049,6,4055,completed
11165,rigid,22614,26680,59111,4066,32431,36497,completed
11166,rigid,22618,26680,26697,4062,17,4079,completed
11167,rigid,22624,26682,26686,4058,4,4062,completed
11168,rigid,22629,26683,26687,4054,4,4058,completed
11169,rigid,22635,26686,26690,4051,4,4055,completed
11170,rigid,22641,26687,26688,4046,1,4047,completed
11171,rigid,22642,26688,26706,4046,18,4064,completed
11172,rigid,22645,26690,32548,4045,5858,9903,completed
11173,rigid,22650,26706,30162,4056,3456,7512,completed
11174,rigid,22650,26710,30166,4060,3456,7516,completed
11175,rigid,22650,26718,101758,4068,75040,79108,completed
11176,rigid,22652,26724,30180,4072,3456,7528,completed
11177,rigid,22654,26724,26741,4070,17,4087,completed
11178,rigid,22663,26728,26912,4065,184,4249,completed
11179,rigid,22672,26800,29949,4128,3149,7277,completed
11180,rigid,22682,26802,26818,4120,16,4136,completed
11181,rigid,22686,26802,26818,4116,16,4132,completed
11182,rigid,22688,26858,26865,4170,7,4177,completed
11183,rigid,22688,26865,26872,4177,7,4184,completed
11184,rigid,22688,26872,26879,4184,7,4191,completed
11185,rigid,22688,26879,26886,4191,7,4198,completed
11186,rigid,22688,26880,26887,4192,7,4199,completed
11187,rigid,22688,26886,26892,4198,6,4204,completed
11188,rigid,22688,26887,26893,4199,6,4205,completed
11189,rigid,22688,26892,26898,4204,6,4210,completed
11190,rigid,22688,26893,26899,4205,6,4211,completed
11191,rigid,22688,26898,26904,4210,6,4216,completed
11192,rigid,22688,26899,26906,4211,7,4218,completed
11193,rigid,22688,26904,26911,4216,7,4223,completed
11194,rigid,22688,26904,26910,4216,6,4222,completed
11195,rigid,22688,26906,26912,4218,6,4224,completed
11196,rigid,22688,26910,26916,4222,6,4228,completed
11197,rigid,22688,26911,26918,4223,7,4230,completed
11198,rigid,22688,26911,26917,4223,6,4229,completed
11199,rigid,22688,26912,26918,4224,6,4230,completed
11200,rigid,22688,26912,26918,4224,6,4230,completed
11201,rigid,22688,26916,26922,4228,6,4234,completed
11202,rigid,22688,26917,26923,4229,6,4235,completed
11203,rigid,22688,26918,26924,4230,6,4236,completed
11204,rigid,22688,26918,26924,4230,6,4236,completed
11205,rigid,22688,26918,26924,4230,6,4236,completed
11206,rigid,22688,26922,26928,4234,6,4240,completed
11207,rigid,22688,26923,26929,4235,6,4241,completed
11208,rigid,22688,26924,26930,4236,6,4242,completed
11209,rigid,22688,26924,26930,4236,6,4242,completed
11210,rigid,22688,26924,26930,4236,6,4242,completed
11211,rigid,22688,26928,26934,4240,6,4246,completed
11212,rigid,22688,26929,26935,4241,6,4247,completed
11213,rigid,22688,26930,26936,4242,6,4248,completed
11214,rigid,22688,26930,26936,4242,6,4248,completed
11215,rigid,22688,26930,26936,4242,6,4248,completed
11216,rigid,22688,26934,26940,4246,6,4252,completed
11217,rigid,22688,26935,26941,4247,6,4253,completed
11218,rigid,22691,26935,26954,4244,19,4263,completed
11219,rigid,22697,26935,26955,4238,20,4258,completed
11220,rigid,22709,26935,26952,4226,17,4243,completed
11221,rigid,22740,26936,26937,4196,1,4197,completed
11222,rigid,22740,26936,26937,4196,1,4197,completed
11223,rigid,22740,26936,26937,4196,1,4197,completed
11224,rigid,22740,26936,26937,4196,1,4197,completed
11225,rigid,22740,26936,26937,4196,1,4197,completed
11226,rigid,22740,26936,26937,4196,1,4197,completed
11227,rigid,22740,26936,26937,4196,1,4197,completed
11228,rigid,22740,26936,26937,4196,1,4197,completed
11229,rigid,22740,26936,26937,4196,1,4197,completed
11230,rigid,22740,26936,26937,4196,1,4197,completed
11231,rigid,22740,26936,26937,4196,1,4197,completed
11232,rigid,22740,26936,26937,4196,1,4197,completed
11233,rigid,22740,26937,26938,4197,1,4198,completed
11234,rigid,22740,26937,26938,4197,1,4198,completed
11235,rigid,22740,26937,26938,4197,1,4198,completed
11236,rigid,22740,26937,26938,4197,1,4198,completed
11237,rigid,22740,26937,26938,4197,1,4198,completed
11238,rigid,22740,26937,26938,4197,1,4198,completed
11239,rigid,22740,26937,26938,4197,1,4198,completed
11240,rigid,22740,26937,26938,4197,1,4198,completed
11241,rigid,22740,26937,26938,4197,1,4198,completed
11242,rigid,22740,26937,26938,4197,1,4198,completed
11243,rigid,22740,26937,26938,4197,1,4198,completed
11244,rigid,22740,26937,26938,4197,1,4198,completed
11245,rigid,22740,26938,26939,4198,1,4199,completed
11246,rigid,22740,26938,26939,4198,1,4199,completed
11247,rigid,22740,26938,26939,4198,1,4199,completed
11248,rigid,22740,26938,26939,4198,1,4199,completed
11249,rigid,22740,26938,26939,4198,1,4199,completed
11250,rigid,22740,26938,26939,4198,1,4199,completed
11251,rigid,22740,26938,26939,4198,1,4199,completed
11252,rigid,22740,26938,26939,4198,1,4199,completed
11253,rigid,22740,26938,26939,4198,1,4199,completed
11254,rigid,22740,26938,26939,4198,1,4199,completed
11255,rigid,22740,26938,26939,4198,1,4199,completed
11256,rigid,22740,26938,26939,4198,1,4199,completed
11257,rigid,22746,26939,28667,4193,1728,5921,completed
11258,rigid,22747,26939,27865,4192,926,5118,completed
11259,rigid,22748,26939,27827,4191,888,5079,completed
11260,rigid,22748,26939,102189,4191,75250,79441,completed
11261,rigid,22754,26939,26942,4185,3,4188,completed
11262,rigid,22754,26939,26970,4185,31,4216,completed
11263,rigid,22777,26973,27837,4196,864,5060,completed
11264,rigid,22784,27050,27055,4266,5,4271,completed
11265,rigid,22785,27055,27056,4270,1,4271,completed
11266,rigid,22790,27056,27341,4266,285,4551,completed
11267,rigid,22810,27062,101517,4252,74455,78707,completed
11268,rigid,22834,27088,101702,4254,74614,78868,completed
11269,rigid,22836,27114,27658,4278,544,4822,completed
11270,rigid,22870,27120,49878,4250,22758,27008,completed
11271,rigid,23079,27122,27207,4043,85,4128,completed
11272,rigid,23101,27122,28071,4021,949,4970,completed
11273,rigid,23101,27124,27844,4023,720,4743,completed
11274,rigid,23101,27124,27767,4023,643,4666,completed
11275,rigid,23115,27124,27128,4009,4,4013,completed
11276,rigid,23120,27130,27159,4010,29,4039,completed
11277,rigid,23120,27140,27169,4020,29,4049,completed
11278,rigid,23122,27142,27146,4020,4,4024,completed
11279,rigid,23129,27142,27153,4013,11,4024,completed
11280,rigid,23132,27142,27143,4010,1,4011,completed
11281,rigid,23133,27142,28283,4009,1141,5150,completed
11282,rigid,23133,27142,28309,4009,1167,5176,completed
11283,rigid,23133,27143,28368,4010,1225,5235,completed
11284,rigid,23136,27146,27147,4010,1,4011,completed
11285,rigid,23137,27147,27148,4010,1,4011,completed
11286,rigid,23138,27148,27645,4010,497,4507,completed
11287,rigid,23138,27150,27866,4012,716,4728,completed
11288,rigid,23138,27150,28519,4012,1369,5381,completed
11289,rigid,23139,27150,27151,4011,1,4012,completed
11290,rigid,23139,27159,27191,4020,32,4052,completed
11291,rigid,23139,27163,27195,4024,32,4056,completed
11292,rigid,23139,27168,27200,4029,32,4061,completed
11293,rigid,23139,27169,27201,4030,32,4062,completed
11294,rigid,23139,27173,27205,4034,32,4066,completed
11295,rigid,23139,27191,27223,4052,32,4084,completed
11296,rigid,23139,27191,27223,4052,32,4084,completed
11297,rigid,23139,27195,27227,4056,32,4088,completed
11298,rigid,23139,27199,27231,4060,32,4092,completed
11299,rigid,23139,27200,27232,4061,32,4093,completed
11300,rigid,23139,27201,27233,4062,32,4094,completed
11301,rigid,23139,27205,27237,4066,32,4098,completed
11302,rigid,23139,27207,27239,4068,32,4100,completed
11303,rigid,23140,27209,27260,4069,51,4120,completed
11304,rigid,23141,27221,50107,4080,22886,26966,completed
11305,rigid,23143,27221,27233,4078,12,4090,completed
11306,rigid,23147,27221,27493,4074,272,4346,completed
11307,rigid,23147,27221,27492,4074,271,4345,completed
11308,rigid,23148,27221,28949,4073,1728,5801,completed
11309,rigid,23152,27221,27323,4069,102,4171,completed
11310,rigid,23152,27221,27323,4069,102,4171,completed
11311,rigid,23156,27221,27225,4065,4,4069,completed
11312,rigid,23157,27236,27263,4079,27,4106,completed
11313,rigid,23164,27237,27304,4073,67,4140,completed
11314,rigid,23165,27239,27243,4074,4,4078,completed
11315,rigid,23167,27239,29831,4072,2592,6664,completed
11316,rigid,23169,27241,28969,4072,1728,5800,completed
11317,rigid,23175,27243,27263,4068,20,4088,completed
11318,rigid,23176,27260,28517,4084,1257,5341,completed
11319,rigid,23176,27260,28647,4084,1387,5471,completed
11320,rigid,23176,27260,27938,4084,678,4762,completed
11321,rigid,23176,27263,28991,4087,1728,5815,completed
11322,rigid,23177,27263,27962,4086,699,4785,completed
11323,rigid,23177,27263,28765,4086,1502,5588,completed
11324,rigid,23177,27263,28002,4086,739,4825,completed
11325,rigid,23185,27263,28991,4078,1728,5806,completed
11326,rigid,23186,27263,27641,4077,378,4455,completed
11327,rigid,23186,27263,27716,4077,453,4530,completed
11328,rigid,23186,27263,27707,4077,444,4521,completed
11329,rigid,23186,27263,27631,4077,368,4445,completed
11330,rigid,23186,27263,27629,4077,366,4443,completed
11331,rigid,23186,27283,27649,4097,366,4463,completed
11332,rigid,23186,27304,27667,4118,363,4481,completed
11333,rigid,23186,27323,27687,4137,364,4501,completed
11334,rigid,23186,27323,27696,4137,373,4510,completed
11335,rigid,23186,27324,27689,4138,365,4503,completed
11336,rigid,23186,27340,27709,4154,369,4523,completed
11337,rigid,23186,27340,27805,4154,465,4619,completed
11338,rigid,23186,27340,27778,4154,438,4592,completed
11339,rigid,23186,27340,27706,4154,366,4520,completed
11340,rigid,23186,27340,27707,4154,367,4521,completed
11341,rigid,23186,27340,27722,4154,382,4536,completed
11342,rigid,23187,27341,27765,4154,424,4578,completed
11343,rigid,23187,27371,27647,4184,276,4460,completed
11344,rigid,23187,27372,29093,4185,1721,5906,completed
11345,rigid,23187,27407,29269,4220,1862,6082,completed
11346,rigid,23191,27455,27484,4264,29,4293,completed
11347,rigid,23193,27484,27790,4291,306,4597,completed
11348,rigid,23194,27492,27494,4298,2,4300,completed
11349,rigid,23197,27493,28228,4296,735,5031,completed
11350,rigid,23199,27493,27557,4294,64,4358,completed
11351,rigid,23199,27493,27602,4294,109,4403,completed
11352,rigid,23199,27493,27630,4294,137,4431,completed
11353,rigid,23199,27493,27629,4294,136,4430,completed
11354,rigid,23199,27493,27669,4294,176,4470,completed
11355,rigid,23199,27493,27634,4294,141,4435,completed
11356,rigid,23199,27493,27688,4294,195,4489,completed
11357,rigid,23199,27493,27673,4294,180,4474,completed
11358,rigid,23199,27494,27652,4295,158,4453,completed
11359,rigid,23199,27494,27896,4295,402,4697,completed
11360,rigid,23199,27557,27737,4358,180,4538,completed
11361,rigid,23199,27560,27690,4361,130,4491,completed
11362,rigid,23199,27602,28008,4403,406,4809,completed
11363,rigid,23199,27629,27864,4430,235,4665,completed
11364,rigid,23199,27629,27751,4430,122,4552,completed
11365,rigid,23199,27629,27750,4430,121,4551,completed
11366,rigid,23199,27629,27715,4430,86,4516,completed
11367,rigid,23199,27629,27990,4430,361,4791,completed
11368,rigid,23199,27629,28032,4430,403,4833,completed
11369,rigid,23199,27630,27795,4431,165,4596,completed
11370,rigid,23199,27631,27799,4432,168,4600,completed
11371,rigid,23199,27631,27772,4432,141,4573,completed
11372,rigid,23199,27631,27867,4432,236,4668,completed
11373,rigid,23199,27631,27748,4432,117,4549,completed
11374,rigid,23199,27634,27810,4435,176,4611,completed
11375,rigid,23199,27641,27772,4442,131,4573,completed
11376,rigid,23199,27641,27721,4442,80,4522,completed
11377,rigid,23199,27641,27853,4442,212,4654,completed
11378,rigid,23199,27641,27771,4442,130,4572,completed
11379,rigid,23199,27641,27878,4442,237,4679,completed
11380,rigid,23199,27644,27784,4445,140,4585,completed
11381,rigid,23199,27645,27762,4446,117,4563,completed
11382,rigid,23199,27647,27769,4448,122,4570,completed
11383,rigid,23199,27647,27826,4448,179,4627,completed
11384,rigid,23199,27647,27676,4448,29,4477,completed
11385,rigid,23199,27647,27702,4448,55,4503,completed
11386,rigid,23199,27647,27751,4448,104,4552,completed
11387,rigid,23199,27647,27859,4448,212,4660,completed
11388,rigid,23199,27647,27918,4448,271,4719,completed
11389,rigid,23199,27647,27916,4448,269,4717,completed
11390,rigid,23199,27647,27773,4448,126,4574,completed
11391,rigid,23199,27647,27827,4448,180,4628,completed
11392,rigid,23199,27647,27817,4448,170,4618,completed
11393,rigid,23199,27647,27748,4448,101,4549,completed
11394,rigid,23199,27647,27788,4448,141,4589,completed
11395,rigid,23199,27647,27769,4448,122,4570,completed
11396,rigid,23199,27649,27765,4450,116,4566,completed
11397,rigid,23199,27649,27887,4450,238,4688,completed
11398,rigid,23199,27649,28053,4450,404,4854,completed
11399,rigid,23199,27649,27766,4450,117,4567,completed
11400,rigid,23199,27652,27854,4453,202,4655,completed
11401,rigid,23199,27658,27871,4459,213,4672,completed
11402,rigid,23199,27658,28062,4459,404,4863,completed
11403,rigid,23199,27658,27768,4459,110,4569,completed
11404,rigid,23199,27658,27765,4459,107,4566,completed
11405,rigid,23199,27658,27953,4459,295,4754,completed
11406,rigid,23199,27667,27798,4468,131,4599,completed
11407,rigid,23199,27667,27743,4468,76,4544,completed
11408,rigid,23199,27667,27903,4468,236,4704,completed
11409,rigid,23199,27667,27789,4468,122,4590,completed
11410,rigid,23199,27669,27826,4470,157,4627,completed
11411,rigid,23199,27672,27824,4473,152,4625,completed
11412,rigid,23199,27672,27813,4473,141,4614,completed
11413,rigid,23199,27672,27793,4473,121,4594,completed
11414,rigid,23199,27672,27941,4473,269,4742,completed
11415,rigid,23199,27672,27845,4473,173,4646,completed
11416,rigid,23199,27673,27909,4474,236,4710,completed
11417,rigid,23199,27676,28080,4477,404,4881,completed
11418,rigid,23199,27687,27807,4488,120,4608,completed
11419,rigid,23199,27688,27720,4489,32,4521,completed
11420,rigid,23199,27689,27721,4490,32,4522,completed
11421,rigid,23199,27696,27728,4497,32,4529,completed
11422,rigid,23199,27706,27739,4507,33,4540,completed
11423,rigid,23199,27707,27739,4508,32,4540,completed
11424,rigid,23199,27707,27739,4508,32,4540,completed
11425,rigid,23200,27707,27768,4507,61,4568,completed
11426,rigid,23200,27707,27807,4507,100,4607,completed
11427,rigid,23200,27709,27832,4509,123,4632,completed
11428,rigid,23200,27709,27832,4509,123,4632,completed
11429,rigid,23200,27709,27862,4509,153,4662,completed
11430,rigid,23200,27709,27835,4509,126,4635,completed
11431,rigid,23200,27711,27879,4511,168,4679,completed
11432,rigid,23200,27715,27797,4515,82,4597,completed
11433,rigid,23200,27716,27793,4516,77,4593,completed
11434,rigid,23200,27716,27812,4516,96,4612,completed
11435,rigid,23200,27716,27810,4516,94,4610,completed
11436,rigid,23200,27716,27743,4516,27,4543,completed
11437,rigid,23200,27716,27875,4516,159,4675,completed
11438,rigid,23200,27720,27862,4520,142,4662,completed
11439,rigid,23200,27720,28062,4520,342,4862,completed
11440,rigid,23200,27720,27878,4520,158,4678,completed
11441,rigid,23200,27720,27840,4520,120,4640,completed
11442,rigid,23200,27721,28063,4521,342,4863,completed
11443,rigid,23200,27721,27924,4521,203,4724,completed
11444,rigid,23200,27721,27834,4521,113,4634,completed
11445,rigid,23200,27721,27829,4521,108,4629,completed
11446,rigid,23200,27721,28028,4521,307,4828,completed
11447,rigid,23200,27721,28064,4521,343,4864,completed
11448,rigid,23200,27722,27869,4522,147,4669,completed
11449,rigid,23200,27722,27875,4522,153,4675,completed
11450,rigid,23200,27722,27848,4522,126,4648,completed
11451,rigid,23200,27722,27927,4522,205,4727,completed
11452,rigid,23200,27728,27837,4528,109,4637,completed
11453,rigid,23200,27728,27879,4528,151,4679,completed
11454,rigid,23200,27728,27848,4528,120,4648,completed
11455,rigid,23200,27728,27911,4528,183,4711,completed
11456,rigid,23200,27728,27847,4528,119,4647,completed
11457,rigid,23200,27737,27942,4537,205,4742,completed
11458,rigid,23200,27739,27865,4539,126,4665,completed
11459,rigid,23200,27739,27848,4539,109,4648,completed
11460,rigid,23200,27739,27852,4539,113,4652,completed
11461,rigid,23200,27739,27897,4539,158,4697,completed
11462,rigid,23200,27739,27921,4539,182,4721,completed
11463,rigid,23200,27739,27971,4539,232,4771,completed
11464,rigid,23200,27739,27972,4539,233,4772,completed
11465,rigid,23200,27739,27851,4539,112,4651,completed
11466,rigid,23200,27739,27897,4539,158,4697,completed
11467,rigid,23200,27739,27890,4539,151,4690,completed
11468,rigid,23200,27739,27865,4539,126,4665,completed
11469,rigid,23200,27739,27852,4539,113,4652,completed
11470,rigid,23200,27739,27793,4539,54,4593,completed
11471,rigid,23200,27743,27852,4543,109,4652,completed
11472,rigid,23200,27743,27947,4543,204,4747,completed
11473,rigid,23200,27748,28091,4548,343,4891,completed
11474,rigid,23200,27748,27856,4548,108,4656,completed
11475,rigid,23200,27750,27922,4550,172,4722,completed
11476,rigid,23200,27751,27934,4551,183,4734,completed
11477,rigid,23200,27751,28091,4551,340,4891,completed
11478,rigid,23200,27762,27863,4562,101,4663,completed
11479,rigid,23200,27765,27865,4565,100,4665,completed
11480,rigid,23200,27765,28013,4565,248,4813,completed
11481,rigid,23200,27765,27885,4565,120,4685,completed
11482,rigid,23200,27765,27970,4565,205,4770,completed
11483,rigid,23200,27765,27878,4565,113,4678,completed
11484,rigid,23200,27765,27906,4565,141,4706,completed
11485,rigid,23200,27765,27899,4565,134,4699,completed
11486,rigid,23200,27765,27892,4565,127,4692,completed
11487,rigid,23200,27765,27873,4565,108,4673,completed
11488,rigid,23200,27766,27998,4566,232,4798,completed
11489,rigid,23200,27767,27917,4567,150,4717,completed
11490,rigid,23200,27768,27838,4568,70,4638,completed
11491,rigid,23200,27768,27973,4568,205,4773,completed
11492,rigid,23200,27769,28112,4569,343,4912,completed
11493,rigid,23200,27769,27877,4569,108,4677,completed
11494,rigid,23201,27771,27834,4570,63,4633,completed
11495,rigid,23201,27772,27881,4571,109,4680,completed
11496,rigid,23201,27772,27895,4571,123,4694,completed
11497,rigid,23201,27773,27896,4572,123,4695,completed
11498,rigid,23201,27778,27949,4577,171,4748,completed
11499,rigid,23201,27778,27899,4577,121,4698,completed
11500,rigid,23201,27778,27972,4577,194,4771,completed
11501,rigid,23201,27778,27957,4577,179,4756,completed
11502,rigid,23201,27778,27920,4577,142,4719,completed
11503,rigid,23201,27784,28188,4583,404,4987,completed
11504,rigid,23201,27788,27968,4587,180,4767,completed
11505,rigid,23201,27789,27912,4588,123,4711,completed
11506,rigid,23201,27790,28191,4589,401,4990,completed
11507,rigid,23201,27790,27997,4589,207,4796,completed
11508,rigid,23201,27790,27909,4589,119,4708,completed
11509,rigid,23201,27790,27912,4589,122,4711,completed
11510,rigid,23201,27793,28155,4592,362,4954,completed
11511,rigid,23201,27793,28145,4592,352,4944,completed
11512,rigid,23201,27793,27960,4592,167,4759,completed
11513,rigid,23201,27795,27940,4594,145,4739,completed
11514,rigid,23201,27797,27918,4596,121,4717,completed
11515,rigid,23201,27798,27881,4597,83,4680,completed
11516,rigid,23201,27799,27877,4598,78,4676,completed
11517,rigid,23201,27805,28013,4604,208,4812,completed
11518,rigid,23201,27805,27915,4604,110,4714,completed
11519,rigid,23201,27805,27978,4604,173,4777,completed
11520,rigid,23201,27805,27928,4604,123,4727,completed
11521,rigid,23201,27805,28020,4604,215,4819,completed
11522,rigid,23201,27807,27930,4606,123,4729,completed
11523,rigid,23201,27807,28015,4606,208,4814,completed
11524,rigid,23201,27810,27930,4609,120,4729,completed
11525,rigid,23201,27810,27921,4609,111,4720,completed
11526,rigid,23201,27812,27924,4611,112,4723,completed
11527,rigid,23201,27813,27993,4612,180,4792,completed
11528,rigid,23201,27817,27914,4616,97,4713,completed
11529,rigid,23201,27824,27854,4623,30,4653,completed
11530,rigid,23201,27825,27875,4624,50,4674,completed
11531,rigid,23201,27826,27929,4625,103,4728,completed
11532,rigid,23201,27826,28040,4625,214,4839,completed
11533,rigid,23201,27827,28094,4626,267,4893,completed
11534,rigid,23201,27829,28096,4628,267,4895,completed
11535,rigid,23201,27832,27964,4631,132,4763,completed
11536,rigid,23201,27832,28012,4631,180,4811,completed
11537,rigid,23201,27834,28002,4633,168,4801,completed
11538,rigid,23201,27834,27955,4633,121,4754,completed
11539,rigid,23201,27835,27947,4634,112,4746,completed
11540,rigid,23201,27837,27948,4636,111,4747,completed
11541,rigid,23201,27837,28045,4636,208,4844,completed
11542,rigid,23201,27837,28237,4636,400,5036,completed
11543,rigid,23201,27837,27949,4636,112,4748,completed
11544,rigid,23201,27837,28037,4636,200,4836,completed
11545,rigid,23201,27837,28050,4636,213,4849,completed
11546,rigid,23201,27837,28238,4636,401,5037,completed
11547,rigid,23201,27837,27946,4636,109,4745,completed
11548,rigid,23201,27837,27941,4636,104,4740,completed
11549,rigid,23201,27837,28113,4636,276,4912,completed
11550,rigid,23201,27837,27960,4636,123,4759,completed
11551,rigid,23201,27837,28044,4636,207,4843,completed
11552,rigid,23201,27837,27913,4636,76,4712,completed
11553,rigid,23201,27837,27956,4636,119,4755,completed
11554,rigid,23201,27837,27979,4636,142,4778,completed
11555,rigid,23201,27837,27997,4636,160,4796,completed
11556,rigid,23201,27837,27957,4636,120,4756,completed
11557,rigid,23201,27837,27960,4636,123,4759,completed
11558,rigid,23201,27837,28104,4636,267,4903,completed
11559,rigid,23201,27837,28010,4636,173,4809,completed
11560,rigid,23201,27837,28046,4636,209,4845,completed
11561,rigid,23201,27837,28187,4636,350,4986,completed
11562,rigid,23201,27837,27961,4636,124,4760,completed
11563,rigid,23201,27837,27896,4636,59,4695,completed
11564,rigid,23201,27837,27936,4636,99,4735,completed
11565,rigid,23201,27837,27950,4636,113,4749,completed
11566,rigid,23201,27837,27949,4636,112,4748,completed
11567,rigid,23201,27837,27989,4636,152,4788,completed
11568,rigid,23201,27837,27947,4636,110,4746,completed
11569,rigid,23201,27837,28005,4636,168,4804,completed
11570,rigid,23201,27837,27996,4636,159,4795,completed
11571,rigid,23201,27837,27965,4636,128,4764,completed
11572,rigid,23201,27837,28169,4636,332,4968,completed
11573,rigid,23201,27837,27912,4636,75,4711,completed
11574,rigid,23201,27837,27910,4636,73,4709,completed
11575,rigid,23201,27838,27934,4637,96,4733,completed
11576,rigid,23201,27840,27998,4639,158,4797,completed
11577,rigid,23201,27844,27957,4643,113,4756,completed
11578,rigid,23201,27845,28180,4644,335,4979,completed
11579,rigid,23201,27847,28027,4646,180,4826,completed
11580,rigid,23201,27848,27960,4647,112,4759,completed
11581,rigid,23201,27848,27957,4647,109,4756,completed
11582,rigid,23201,27848,28155,4647,307,4954,completed
11583,rigid,23201,27851,28145,4650,294,4944,completed
11584,rigid,23201,27852,28001,4651,149,4800,completed
11585,rigid,23201,27852,27982,4651,130,4781,completed
11586,rigid,23201,27852,27962,4651,110,4761,completed
11587,rigid,23201,27853,28031,4652,178,4830,completed
11588,rigid,23201,27854,27956,4653,102,4755,completed
11589,rigid,23201,27854,28005,4653,151,4804,completed
11590,rigid,23201,27856,27969,4655,113,4768,completed
11591,rigid,23201,27859,28048,4658,189,4847,completed
11592,rigid,23201,27862,27974,4661,112,4773,completed
11593,rigid,23201,27862,28041,4661,179,4840,completed
11594,rigid,23201,27863,27972,4662,109,4771,completed
11595,rigid,23201,27864,27966,4663,102,4765,completed
11596,rigid,23201,27865,27971,4664,106,4770,completed
11597,rigid,23201,27865,28023,4664,158,4822,completed
11598,rigid,23201,27865,28054,4664,189,4853,completed
11599,rigid,23201,27865,28094,4664,229,4893,completed
11600,rigid,23201,27866,28095,4665,229,4894,completed
11601,rigid,23201,27867,27984,4666,117,4783,completed
11602,rigid,23201,27869,27956,4668,87,4755,completed
11603,rigid,23201,27871,27899,4670,28,4698,completed
11604,rigid,23201,27873,27972,4672,99,4771,completed
11605,rigid,23201,27875,27970,4674,95,4769,completed
11606,rigid,23201,27875,27923,4674,48,4722,completed
11607,rigid,23201,27875,28035,4674,160,4834,completed
11608,rigid,23201,27877,28027,4676,150,4826,completed
11609,rigid,23201,27877,27987,4676,110,4786,completed
11610,rigid,23201,27878,27984,4677,106,4783,completed
11611,rigid,23201,27878,27980,4677,102,4779,completed
11612,rigid,23201,27878,28058,4677,180,4857,completed
11613,rigid,23201,27879,28212,4678,333,5011,completed
11614,rigid,23201,27879,27981,4678,102,4780,completed
11615,rigid,23201,27881,28051,4680,170,4850,completed
11616,rigid,23201,27881,28070,4680,189,4869,completed
11617,rigid,23201,27885,28217,4684,332,5016,completed
11618,rigid,23201,27887,28118,4686,231,4917,completed
11619,rigid,23201,27890,28002,4689,112,4801,completed
11620,rigid,23201,27892,28071,4691,179,4870,completed
11621,rigid,23201,27895,28007,4694,112,4806,completed
11622,rigid,23201,27896,28024,4695,128,4823,completed
11623,rigid,23201,27896,27966,4695,70,4765,completed
11624,rigid,23201,27896,28036,4695,140,4835,completed
11625,rigid,23201,27897,28006,4696,109,4805,completed
11626,rigid,23201,27897,28007,4696,110,4806,completed
11627,rigid,23201,27897,28126,4696,229,4925,completed
11628,rigid,23201,27897,28049,4696,152,4848,completed
11629,rigid,23201,27897,28075,4696,178,4874,completed
11630,rigid,23201,27897,28192,4696,295,4991,completed
11631,rigid,23201,27899,28009,4698,110,4808,completed
11632,rigid,23209,27909,27938,4700,29,4729,completed
11633,rigid,23209,27912,27941,4703,29,4732,completed
11634,rigid,23209,27914,27943,4705,29,4734,completed
11635,rigid,23209,27916,27945,4707,29,4736,completed
11636,rigid,23215,27916,27928,4701,12,4713,completed
11637,rigid,23225,27917,28813,4692,896,5588,completed
11638,rigid,23225,27918,30510,4693,2592,7285,completed
11639,rigid,23225,27918,29958,4693,2040,6733,completed
11640,rigid,23225,27921,30513,4696,2592,7288,completed
11641,rigid,23225,27921,28723,4696,802,5498,completed
11642,rigid,23225,27922,30379,4697,2457,7154,completed
11643,rigid,23225,27923,30515,4698,2592,7290,completed
11644,rigid,23225,27924,30516,4699,2592,7291,completed
11645,rigid,23225,27924,28503,4699,579,5278,completed
11646,rigid,23225,27927,30519,4702,2592,7294,completed
11647,rigid,23225,27928,30520,4703,2592,7295,completed
11648,rigid,23225,27930,29250,4705,1320,6025,completed
11649,rigid,23225,27930,30522,4705,2592,7297,completed
11650,rigid,23225,27934,28690,4709,756,5465,completed
11651,rigid,23225,27934,30255,4709,2321,7030,completed
11652,rigid,23225,27936,30528,4711,2592,7303,completed
11653,rigid,23225,27938,30530,4713,2592,7305,completed
11654,rigid,23225,27938,30530,4713,2592,7305,completed
11655,rigid,23225,27938,28899,4713,961,5674,completed
11656,rigid,23225,27938,30530,4713,2592,7305,completed
11657,rigid,23225,27938,30213,4713,2275,6988,completed
11658,rigid,23225,27940,29244,4715,1304,6019,completed
11659,rigid,23225,27941,30533,4716,2592,7308,completed
11660,rigid,23225,27941,30533,4716,2592,7308,completed
11661,rigid,23225,27941,28734,4716,793,5509,completed
11662,rigid,23225,27941,28811,4716,870,5586,completed
11663,rigid,23225,27941,30533,4716,2592,7308,completed
11664,rigid,23225,27941,28595,4716,654,5370,completed
11665,rigid,23225,27942,30534,4717,2592,7309,completed
11666,rigid,23225,27943,30535,4718,2592,7310,completed
11667,rigid,23225,27943,30535,4718,2592,7310,completed
11668,rigid,23225,27943,27997,4718,54,4772,completed
11669,rigid,23225,27943,30535,4718,2592,7310,completed
11670,rigid,23225,27945,28109,4720,164,4884,completed
11671,rigid,23225,27945,30537,4720,2592,7312,completed
11672,rigid,23225,27945,30537,4720,2592,7312,completed
11673,rigid,23225,27945,28915,4720,970,5690,completed
11674,rigid,23225,27946,28266,4721,320,5041,completed
11675,rigid,23225,27947,28459,4722,512,5234,completed
11676,rigid,23225,27947,30539,4722,2592,7314,completed
11677,rigid,23225,27947,30539,4722,2592,7314,completed
11678,rigid,23225,27949,30541,4724,2592,7316,completed
11679,rigid,23225,27949,30541,4724,2592,7316,completed
11680,rigid,23225,27949,30541,4724,2592,7316,completed
11681,rigid,23225,27950,30542,4725,2592,7317,completed
11682,rigid,23225,27953,30545,4728,2592,7320,completed
11683,rigid,23225,27955,30547,4730,2592,7322,completed
11684,rigid,23225,27956,30548,4731,2592,7323,completed
11685,rigid,23225,27956,30548,4731,2592,7323,completed
11686,rigid,23225,27957,30549,4732,2592,7324,completed
11687,rigid,23225,27957,30549,4732,2592,7324,completed
11688,rigid,23225,27957,30549,4732,2592,7324,completed
11689,rigid,23225,27957,30247,4732,2290,7022,completed
11690,rigid,23225,27960,29268,4735,1308,6043,completed
11691,rigid,23225,27960,28287,4735,327,5062,completed
11692,rigid,23225,27960,29786,4735,1826,6561,completed
11693,rigid,23225,27960,30552,4735,2592,7327,completed
11694,rigid,23225,27962,30554,4737,2592,7329,completed
11695,rigid,23225,27962,30554,4737,2592,7329,completed
11696,rigid,23225,27964,28233,4739,269,5008,completed
11697,rigid,23225,27965,29644,4740,1679,6419,completed
11698,rigid,23225,27966,30558,4741,2592,7333,completed
11699,rigid,23225,27966,29063,4741,1097,5838,completed
11700,rigid,23225,27968,28029,4743,61,4804,completed
11701,rigid,23225,27969,30561,4744,2592,7336,completed
11702,rigid,23225,27970,30562,4745,2592,7337,completed
11703,rigid,23225,27971,30563,4746,2592,7338,completed
11704,rigid,23225,27971,30563,4746,2592,7338,completed
11705,rigid,23225,27972,30564,4747,2592,7339,completed
11706,rigid,23225,27972,28693,4747,721,5468,completed
11707,rigid,23225,27972,30564,4747,2592,7339,completed
11708,rigid,23225,27972,28159,4747,187,4934,completed
11709,rigid,23225,27973,30565,4748,2592,7340,completed
11710,rigid,23225,27974,30566,4749,2592,7341,completed
11711,rigid,23225,27979,28269,4754,290,5044,completed
11712,rigid,23225,27980,29762,4755,1782,6537,completed
11713,rigid,23225,27981,30573,4756,2592,7348,completed
11714,rigid,23225,27982,29915,4757,1933,6690,completed
11715,rigid,23225,27984,30576,4759,2592,7351,completed
11716,rigid,23225,27984,29276,4759,1292,6051,completed
11717,rigid,23225,27987,29537,4762,1550,6312,completed
11718,rigid,23225,27989,30581,4764,2592,7356,completed
11719,rigid,23225,27993,30145,4768,2152,6920,completed
11720,rigid,23225,27996,28624,4771,628,5399,completed
11721,rigid,23225,27997,30227,4772,2230,7002,completed
11722,rigid,23225,27997,30146,4772,2149,6921,completed
11723,rigid,23225,27997,30589,4772,2592,7364,completed
11724,rigid,23225,27998,30590,4773,2592,7365,completed
11725,rigid,23225,27998,29912,4773,1914,6687,completed
11726,rigid,23225,28002,30594,4777,2592,7369,completed
11727,rigid,23225,28005,30597,4780,2592,7372,completed
11728,rigid,23225,28006,30598,4781,2592,7373,completed
11729,rigid,23225,28006,30598,4781,2592,7373,completed
11730,rigid,23225,28007,29267,4782,1260,6042,completed
11731,rigid,23225,28007,30599,4782,2592,7374,completed
11732,rigid,23225,28008,30600,4783,2592,7375,completed
11733,rigid,23225,28010,29674,4785,1664,6449,completed
11734,rigid,23225,28012,29915,4787,1903,6690,completed
11735,rigid,23225,28013,30605,4788,2592,7380,completed
11736,rigid,23225,28023,30615,4798,2592,7390,completed
11737,rigid,23225,28026,30618,4801,2592,7393,completed
11738,rigid,23225,28027,30619,4802,2592,7394,completed
11739,rigid,23225,28029,30621,4804,2592,7396,completed
11740,rigid,23225,28032,30231,4807,2199,7006,completed
11741,rigid,23225,28036,28496,4811,460,5271,completed
11742,rigid,23225,28037,28568,4812,531,5343,completed
11743,rigid,23225,28040,28577,4815,537,5352,completed
11744,rigid,23225,28041,28993,4816,952,5768,completed
11745,rigid,23225,28044,30636,4819,2592,7411,completed
11746,rigid,23225,28045,30637,4820,2592,7412,completed
11747,rigid,23225,28046,30638,4821,2592,7413,completed
11748,rigid,23225,28048,30640,4823,2592,7415,completed
11749,rigid,23225,28050,30642,4825,2592,7417,completed
11750,rigid,23225,28051,30643,4826,2592,7418,completed
11751,rigid,23225,28053,29569,4828,1516,6344,completed
11752,rigid,23225,28054,30646,4829,2592,7421,completed
11753,rigid,23225,28058,29214,4833,1156,5989,completed
11754,rigid,23225,28062,28237,4837,175,5012,completed
11755,rigid,23225,28062,28450,4837,388,5225,completed
11756,rigid,23225,28063,28777,4838,714,5552,completed
11757,rigid,23225,28070,29259,4845,1189,6034,completed
11758,rigid,23225,28071,30663,4846,2592,7438,completed
11759,rigid,23225,28071,29823,4846,1752,6598,completed
11760,rigid,23225,28075,30667,4850,2592,7442,completed
11761,rigid,23228,28075,28078,4847,3,4850,completed
11762,rigid,23232,28076,28426,4844,350,5194,completed
11763,rigid,23239,28076,28120,4837,44,4881,completed
11764,rigid,23248,28076,28077,4828,1,4829,completed
11765,rigid,23249,28076,28077,4827,1,4828,completed
11766,rigid,23250,28076,28077,4826,1,4827,completed
11767,rigid,23250,28076,28077,4826,1,4827,completed
11768,rigid,23250,28076,28077,4826,1,4827,completed
11769,rigid,23263,28076,28085,4813,9,4822,completed
11770,rigid,23263,28077,28086,4814,9,4823,completed
11771,rigid,23263,28077,28086,4814,9,4823,completed
11772,rigid,23263,28080,28089,4817,9,4826,completed
11773,rigid,23263,28085,28094,4822,9,4831,completed
11774,rigid,23263,28086,28095,4823,9,4832,completed
11775,rigid,23270,28094,28153,4824,59,4883,completed
11776,rigid,23275,28104,29773,4829,1669,6498,completed
11777,rigid,23288,28114,28145,4826,31,4857,completed
11778,rigid,23288,28120,28151,4832,31,4863,completed
11779,rigid,23288,28126,28157,4838,31,4869,completed
11780,rigid,23288,28145,28176,4857,31,4888,completed
11781,rigid,23288,28151,28182,4863,31,4894,completed
11782,rigid,23288,28153,28184,4865,31,4896,completed
11783,rigid,23290,28153,28155,4863,2,4865,completed
11784,rigid,23299,28153,28191,4854,38,4892,completed
11785,rigid,23339,28153,28192,4814,39,4853,completed
11786,rigid,23351,28153,29502,4802,1349,6151,completed
11787,rigid,23351,28153,28975,4802,822,5624,completed
11788,rigid,23351,28153,29172,4802,1019,5821,completed
11789,rigid,23356,28153,28155,4797,2,4799,completed
11790,rigid,23356,28153,28155,4797,2,4799,completed
11791,rigid,23356,28153,28155,4797,2,4799,completed
11792,rigid,23358,28155,28156,4797,1,4798,completed
11793,rigid,23358,28155,28156,4797,1,4798,completed
11794,rigid,23358,28155,28156,4797,1,4798,completed
11795,rigid,23376,28156,28157,4780,1,4781,completed
11796,rigid,23376,28156,28157,4780,1,4781,completed
11797,rigid,23378,28156,28157,4778,1,4779,completed
11798,rigid,23378,28156,28157,4778,1,4779,completed
11799,rigid,23380,28156,28157,4776,1,4777,completed
11800,rigid,23380,28156,28157,4776,1,4777,completed
11801,rigid,23381,28156,28188,4775,32,4807,completed
11802,rigid,23382,28156,28684,4774,528,5302,completed
11803,rigid,23382,28157,28647,4775,490,5265,completed
11804,rigid,23382,28157,28669,4775,512,5287,completed
11805,rigid,23382,28157,28611,4775,454,5229,completed
11806,rigid,23382,28157,28620,4775,463,5238,completed
11807,rigid,23382,28157,28609,4775,452,5227,completed
11808,rigid,23382,28159,28709,4777,550,5327,completed
11809,rigid,23382,28169,28718,4787,549,5336,completed
11810,rigid,23382,28176,28605,4794,429,5223,completed
11811,rigid,23382,28176,28607,4794,431,5225,completed
11812,rigid,23382,28176,28613,4794,437,5231,completed
11813,rigid,23382,28176,28606,4794,430,5224,completed
11814,rigid,23392,28176,28209,4784,33,4817,completed
11815,rigid,23409,28180,28181,4771,1,4772,completed
11816,rigid,23409,28181,28182,4772,1,4773,completed
11817,rigid,23410,28182,28183,4772,1,4773,completed
11818,rigid,23410,28182,28183,4772,1,4773,completed
11819,rigid,23410,28182,28183,4772,1,4773,completed
11820,rigid,23412,28182,28194,4770,12,4782,completed
11821,rigid,23413,28182,28194,4769,12,4781,completed
11822,rigid,23413,28183,28195,4770,12,4782,completed
11823,rigid,23413,28183,28195,4770,12,4782,completed
11824,rigid,23414,28183,28217,4769,34,4803,completed
11825,rigid,23421,28183,28185,4762,2,4764,completed
11826,rigid,23421,28183,28185,4762,2,4764,completed
11827,rigid,23421,28183,28186,4762,3,4765,completed
11828,rigid,23424,28183,28185,4759,2,4761,completed
11829,rigid,23424,28183,28185,4759,2,4761,completed
11830,rigid,23424,28183,28185,4759,2,4761,completed
11831,rigid,23424,28184,30294,4760,2110,6870,completed
11832,rigid,23425,28184,28215,4759,31,4790,completed
11833,rigid,23429,28184,28188,4755,4,4759,completed
11834,rigid,23429,28184,28186,4755,2,4757,completed
11835,rigid,23429,28184,28186,4755,2,4757,completed
11836,rigid,23429,28184,28186,4755,2,4757,completed
11837,rigid,23430,28184,28188,4754,4,4758,completed
11838,rigid,23431,28184,28239,4753,55,4808,completed
11839,rigid,23431,28184,28239,4753,55,4808,completed
11840,rigid,23431,28186,31065,4755,2879,7634,completed
11841,rigid,23431,28188,30996,4757,2808,7565,completed
11842,rigid,23431,28191,30644,4760,2453,7213,completed
11843,rigid,23431,28192,30597,4761,2405,7166,completed
11844,rigid,23431,28195,30716,4764,2521,7285,completed
11845,rigid,23431,28217,31301,4786,3084,7870,completed
11846,rigid,23431,28228,31205,4797,2977,7774,completed
11847,rigid,23432,28233,28292,4801,59,4860,completed
11848,rigid,23432,28266,30062,4834,1796,6630,completed
11849,rigid,23432,28272,30527,4840,2255,7095,completed
11850,rigid,23432,28309,31100,4877,2791,7668,completed
11851,rigid,23432,28450,30753,5018,2303,7321,completed
11852,rigid,23432,28503,30600,5071,2097,7168,completed
11853,rigid,23432,28568,31621,5136,3053,8189,completed
11854,rigid,23432,28606,31278,5174,2672,7846,completed
11855,rigid,23432,28613,30804,5181,2191,7372,completed
11856,rigid,23432,28647,30991,5215,2344,7559,completed
11857,rigid,23435,28669,28670,5234,1,5235,completed
11858,rigid,23435,28670,28672,5235,2,5237,completed
11859,rigid,23435,28672,28673,5237,1,5238,completed
11860,rigid,23436,28673,28674,5237,1,5238,completed
11861,rigid,23436,28674,28675,5238,1,5239,completed
11862,rigid,23436,28677,28678,5241,1,5242,completed
11863,rigid,23436,28677,28678,5241,1,5242,completed
11864,rigid,23436,28677,28678,5241,1,5242,completed
11865,rigid,23465,28677,51589,5212,22912,28124,completed
11866,rigid,23478,28677,28678,5199,1,5200,completed
11867,rigid,23480,28677,29366,5197,689,5886,completed
11868,rigid,23480,28678,29369,5198,691,5889,completed
11869,rigid,23480,28678,29368,5198,690,5888,completed
11870,rigid,23480,28693,29395,5213,702,5915,completed
11871,rigid,23480,28714,29403,5234,689,5923,completed
11872,rigid,23480,28714,29405,5234,691,5925,completed
11873,rigid,23480,28714,29403,5234,689,5923,completed
11874,rigid,23480,28714,29399,5234,685,5919,completed
11875,rigid,23517,28714,28748,5197,34,5231,completed
11876,rigid,23564,28714,28715,5150,1,5151,completed
11877,rigid,23564,28723,28736,5159,13,5172,completed
11878,rigid,23596,28724,28743,5128,19,5147,completed
11879,rigid,23598,28724,28742,5126,18,5144,completed
11880,rigid,23599,28724,28741,5125,17,5142,completed
11881,rigid,23600,28724,28741,5124,17,5141,completed
11882,rigid,23601,28724,28740,5123,16,5139,completed
11883,rigid,23602,28734,28749,5132,15,5147,completed
11884,rigid,23603,28736,28751,5133,15,5148,completed
11885,rigid,23638,28740,34622,5102,5882,10984,completed
11886,rigid,23642,28743,34723,5101,5980,11081,completed
11887,rigid,23645,28755,29282,5110,527,5637,completed
11888,rigid,23646,28811,29279,5165,468,5633,completed
11889,rigid,23646,28819,29290,5173,471,5644,completed
11890,rigid,23646,28949,29422,5303,473,5776,completed
11891,rigid,23646,28969,29446,5323,477,5800,completed
11892,rigid,23646,28975,29458,5329,483,5812,completed
11893,rigid,23646,28991,29471,5345,480,5825,completed
11894,rigid,23646,29063,29549,5417,486,5903,completed
11895,rigid,23646,29146,29630,5500,484,5984,completed
11896,rigid,23646,29172,29677,5526,505,6031,completed
11897,rigid,23646,29259,29761,5613,502,6115,completed
11898,rigid,23646,29269,29792,5623,523,6146,completed
11899,rigid,23646,29269,29270,5623,1,5624,completed
11900,rigid,23646,29276,35147,5630,5871,11501,completed
11901,rigid,23691,29279,31508,5588,2229,7817,completed
11902,rigid,23691,29282,31932,5591,2650,8241,completed
11903,rigid,23691,29290,31170,5599,1880,7479,completed
11904,rigid,23691,29366,31819,5675,2453,8128,completed
11905,rigid,23691,29368,31610,5677,2242,7919,completed
11906,rigid,23691,29369,31479,5678,2110,7788,completed
11907,rigid,23691,29395,31446,5704,2051,7755,completed
11908,rigid,23691,29399,32054,5708,2655,8363,completed
11909,rigid,23691,29403,31928,5712,2525,8237,completed
11910,rigid,23691,29403,32261,5712,2858,8570,completed
11911,rigid,23691,29405,31839,5714,2434,8148,completed
11912,rigid,23691,29422,31935,5731,2513,8244,completed
11913,rigid,23691,29446,31781,5755,2335,8090,completed
11914,rigid,23691,29458,32089,5767,2631,8398,completed
11915,rigid,23691,29471,32132,5780,2661,8441,completed
11916,rigid,23691,29549,31940,5858,2391,8249,completed
11917,rigid,23808,29549,29553,5741,4,5745,completed
11918,rigid,23810,29630,42543,5820,12913,18733,completed
11919,rigid,23816,29630,29632,5814,2,5816,completed
11920,rigid,23816,29630,29632,5814,2,5816,completed
11921,rigid,23817,29630,29632,5813,2,5815,completed
11922,rigid,23817,29632,29634,5815,2,5817,completed
11923,rigid,23818,29632,29633,5814,1,5815,completed
11924,rigid,23818,29632,29634,5814,2,5816,completed
11925,rigid,23818,29633,29634,5815,1,5816,completed
11926,rigid,23818,29634,29635,5816,1,5817,completed
11927,rigid,23821,29634,29635,5813,1,5814,completed
11928,rigid,23821,29634,29635,5813,1,5814,completed
11929,rigid,23821,29635,29636,5814,1,5815,completed
11930,rigid,23821,29635,29636,5814,1,5815,completed
11931,rigid,23823,29635,29636,5812,1,5813,completed
11932,rigid,23823,29636,29637,5813,1,5814,completed
11933,rigid,23823,29636,29637,5813,1,5814,completed
11934,rigid,23823,29636,29637,5813,1,5814,completed
11935,rigid,23828,29637,29639,5809,2,5811,completed
11936,rigid,23828,29637,29638,5809,1,5810,completed
11937,rigid,23829,29637,29638,5808,1,5809,completed
11938,rigid,23829,29638,29639,5809,1,5810,completed
11939,rigid,23829,29638,29639,5809,1,5810,completed
11940,rigid,23829,29639,29640,5810,1,5811,completed
11941,rigid,23831,29639,29640,5808,1,5809,completed
11942,rigid,23831,29640,29641,5809,1,5810,completed
11943,rigid,23834,29640,29641,5806,1,5807,completed
11944,rigid,23834,29641,29642,5807,1,5808,completed
11945,rigid,23834,29641,29642,5807,1,5808,completed
11946,rigid,23835,29642,29643,5807,1,5808,completed
11947,rigid,23835,29643,29644,5808,1,5809,completed
11948,rigid,23842,29643,29647,5801,4,5805,completed
11949,rigid,23842,29644,29646,5802,2,5804,completed
11950,rigid,23842,29644,29646,5802,2,5804,completed
11951,rigid,23842,29644,29647,5802,3,5805,completed
11952,rigid,23842,29646,29649,5804,3,5807,completed
11953,rigid,23842,29646,29648,5804,2,5806,completed
11954,rigid,23853,29647,29648,5794,1,5795,completed
11955,rigid,23853,29647,29648,5794,1,5795,completed
11956,rigid,23853,29648,29649,5795,1,5796,completed
11957,rigid,23853,29648,29649,5795,1,5796,completed
11958,rigid,23853,29648,29650,5795,2,5797,completed
11959,rigid,23853,29649,29650,5796,1,5797,completed
11960,rigid,23853,29649,29650,5796,1,5797,completed
11961,rigid,23853,29649,29650,5796,1,5797,completed
11962,rigid,23853,29650,29651,5797,1,5798,completed
11963,rigid,23853,29650,29651,5797,1,5798,completed
11964,rigid,23857,29650,29651,5793,1,5794,completed
11965,rigid,23857,29650,29651,5793,1,5794,completed
11966,rigid,23857,29651,29652,5794,1,5795,completed
11967,rigid,23857,29651,29652,5794,1,5795,completed
11968,rigid,23860,29651,29652,5791,1,5792,completed
11969,rigid,23860,29651,29652,5791,1,5792,completed
11970,rigid,23860,29652,29653,5792,1,5793,completed
11971,rigid,23860,29652,29653,5792,1,5793,completed
11972,rigid,23938,29653,29654,5715,1,5716,completed
11973,rigid,23938,29653,29654,5715,1,5716,completed
11974,rigid,23939,29653,29654,5714,1,5715,completed
11975,rigid,23940,29653,29665,5713,12,5725,completed
11976,rigid,23940,29654,29666,5714,12,5726,completed
11977,rigid,23940,29654,29666,5714,12,5726,completed
11978,rigid,23941,29654,29666,5713,12,5725,completed
11979,rigid,23970,29666,29857,5696,191,5887,completed
11980,rigid,23975,29666,30685,5691,1019,6710,completed
11981,rigid,23975,29666,30163,5691,497,6188,completed
11982,rigid,23975,29674,30920,5699,1246,6945,completed
11983,rigid,23976,29674,30650,5698,976,6674,completed
11984,rigid,23976,29677,30696,5701,1019,6720,completed
11985,rigid,23976,29677,30381,5701,704,6405,completed
11986,rigid,23977,29677,30814,5700,1137,6837,completed
11987,rigid,23977,29677,30732,5700,1055,6755,completed
11988,rigid,23977,29761,30590,5784,829,6613,completed
11989,rigid,23980,29762,29791,5782,29,5811,completed
11990,rigid,23983,29773,30799,5790,1026,6816,completed
11991,rigid,23983,29773,30726,5790,953,6743,completed
11992,rigid,23983,29773,29863,5790,90,5880,completed
11993,rigid,24000,29791,31683,5791,1892,7683,completed
11994,rigid,24262,29792,35230,5530,5438,10968,completed
11995,rigid,24307,29857,32222,5550,2365,7915,completed
11996,rigid,24441,29915,30590,5474,675,6149,completed
11997,rigid,24580,29938,30710,5358,772,6130,completed
11998,rigid,25359,29949,30533,4590,584,5174,completed
11999,rigid,25375,29949,33608,4574,3659,8233,completed
12000,rigid,25696,29956,32134,4260,2178,6438,completed
12001,rigid,25696,30062,32753,4366,2691,7057,completed
12002,rigid,25696,30162,32208,4466,2046,6512,completed
12003,rigid,25696,30162,32502,4466,2340,6806,completed
12004,rigid,25696,30166,33247,4470,3081,7551,completed
12005,rigid,25696,30180,33164,4484,2984,7468,completed
12006,rigid,25696,30180,32954,4484,2774,7258,completed
12007,rigid,25696,30231,32970,4535,2739,7274,completed
12008,rigid,25697,30294,32400,4597,2106,6703,completed
12009,rigid,25697,30513,32953,4816,2440,7256,completed
12010,rigid,25697,30520,33606,4823,3086,7909,completed
12011,rigid,25697,30527,32590,4830,2063,6893,completed
12012,rigid,25697,30530,33230,4833,2700,7533,completed
12013,rigid,25697,30533,33174,4836,2641,7477,completed
12014,rigid,25697,30533,33224,4836,2691,7527,completed
12015,rigid,25697,30535,32492,4838,1957,6795,completed
12016,rigid,26305,30539,32771,4234,2232,6466,completed
12017,rigid,26305,30542,32528,4237,1986,6223,completed
12018,rigid,26305,30548,33225,4243,2677,6920,completed
12019,rigid,26305,30552,33270,4247,2718,6965,completed
12020,rigid,26305,30561,32909,4256,2348,6604,completed
12021,rigid,26305,30564,33187,4259,2623,6882,completed
12022,rigid,26305,30573,32535,4268,1962,6230,completed
12023,rigid,26305,30590,32669,4285,2079,6364,completed
12024,rigid,26305,30590,32798,4285,2208,6493,completed
12025,rigid,26305,30597,32568,4292,1971,6263,completed
12026,rigid,26305,30597,33207,4292,2610,6902,completed
12027,rigid,26307,30598,32350,4291,1752,6043,completed
12028,rigid,26311,30600,32707,4289,2107,6396,completed
12029,rigid,26311,30600,32681,4289,2081,6370,completed
12030,rigid,26313,30615,32354,4302,1739,6041,completed
12031,rigid,26314,30619,32092,4305,1473,5778,completed
12032,rigid,26759,30636,33506,3877,2870,6747,completed
12033,rigid,26818,30642,33071,3824,2429,6253,completed
12034,rigid,27098,30644,32758,3546,2114,5660,completed
12035,rigid,27398,30663,31402,3265,739,4004,completed
12036,rigid,27398,30710,31566,3312,856,4168,completed
12037,rigid,27398,30716,32235,3318,1519,4837,completed
12038,rigid,27398,30726,32029,3328,1303,4631,completed
12039,rigid,27398,30753,31879,3355,1126,4481,completed
12040,rigid,27398,30804,31621,3406,817,4223,completed
12041,rigid,27398,30920,31788,3522,868,4390,completed
12042,rigid,27398,30991,31815,3593,824,4417,completed
12043,rigid,27398,30996,32460,3598,1464,5062,completed
12044,rigid,27398,31065,31639,3667,574,4241,completed
12045,rigid,27398,31100,31969,3702,869,4571,completed
12046,rigid,27398,31170,32276,3772,1106,4878,completed
12047,rigid,27398,31205,32138,3807,933,4740,completed
12048,rigid,27398,31278,32152,3880,874,4754,completed
12049,rigid,27398,31301,31990,3903,689,4592,completed
12050,rigid,27398,31402,32925,4004,1523,5527,completed
12051,rigid,29604,31446,33300,1842,1854,3696,completed
12052,rigid,29927,31479,33234,1552,1755,3307,completed
12053,rigid,29938,31508,33304,1570,1796,3366,completed
